; Debug/Test cave(s).

[BDCFF]
[game]
Name=Debug/Test
Author=Irmen de Jong
Charset=Original
Fontset=Original
Levels=1
Caves=2

[cave]
Name=Test Cave 1
Description=To test mechanics with
CaveDelay=8
CaveTime=200
DiamondsRequired=5
DiamondValue=1 3
MagicWallTime=20
AmoebaTime=60
SlimePermeability=0.750
Colors=Black Black Orange Brown Cyan

[map]
WWWWWWWWWWWWWWWWWWWWWWWWWWWWWWWWWWWWWWWW
W           r                          W
W          dd                          W
W        dr r                          W
W       rd  d                          W
W       r   r                          W
W      d    d                          W
W     r     r         Q  Q  Q  Q       W
W......................................W
W          C  C  C  C                  W
W            rd                        W
Wssss...sssssssssssssssssssssssssssssssW
W          P                           W
W                        rrr%%%ddDD    W
W      .r.    .d...      ......d...    W
W      ...    ...x...    MMMMMMMMMM    W
W      . .   .. ...V.                  W
W      . .   v. . ...                  W
W      . .   .. .         W  aa  W     W
W      . .    . .         WWWWWWWW     H
W      .C.    .Q.                      X
WWWWWWWWWWWWWWWWWWWWWWWWWWWWWWWWWWWWWWWW
[/map]
[/cave]

[cave]
Name=Test Cave 2
Description=Which direction should you choose first?
CaveDelay=8
CaveTime=200
DiamondsRequired=5
DiamondValue=1 3
AmoebaTime=60
MagicWallTime=20
Colors=Black Black Gray1 Red Yellow

[map]
 ssw..............................wss
 ssw.WWWWWWWWWWWWWWWWWWWWWWWWWWWW..wss
ssw..W              W           W..wsss
ssw..W WWWWWWWWWWWW W WWWWWWWWW W.wssss
sssw.W W          W W W       W W..wssss
ssw..W W WWWWWWWW W W W WWWWW W W..wssss
ssw..W W       dW W W W    dW W W.wsssss
sssw.W WWWWWWWWWW W W WWWWWWWQW W..wssss
ssw..W            W W         W W..wssss
ssw..WWWWWWWWWWWWWW WWWWWWWWWWW W..wssss
sssw..W            P            W...wsss
sssw..W WWWWWWWWWWW WWWWWWWWWWWWWWW.wsss
sssw..W W         W Wc            W..wss
ssssw.W W WWWWWWW W W WWWWWWWWWWW W.wsss
sssw..W W W     W W W Wd        W W.wsss
sssw..W W W WXW W W W WWWWWWWWW W W..wss
ssssw.W W W  dW W W W           W W.wsss
sssw..W W WWWWW W W WWWWWWWWWWWWW W.wsss
sssw..W W       W W               W..wss
ssssw.W WWWWWWWWW WWWWWWWWWWWWWWWWW.wsss
 ssw..W           W.................wss
 ssw..WWWWWWWWWWWWW...wwwwwwwwwwwwwwss
[/map]
[/cave]
[/game]
[/BDCFF]
