; Converted using Tim Stridmann's X2BDCFF converter.
; Last modified: 14 June 2006

[BDCFF]

[game]
Name=Arno Dash 5
Date=March 2003
Author=Arno Weber
WWW=http://www.boulder-dash.nl/
Charset=Original
Fontset=Original
Levels=1
Caves=20

[cave]
Name=Cave 1
CaveDelay=8
CaveTime=200
DiamondsRequired=85
DiamondValue=6 8
Colors=Black Black Green Orange Red

[map]
WWWWWWWWWWWWWWWWWWWWWWWWWWWWWWWWWWWWWWWW
WdrrrrWrrww    qwwq    wWrrrrrrW.rrrrrdW
WdddddW..   w  w   w w  WdddddrW.rrrrr.W
WdWWW.w Ww w  w   ww   wWrrrrrdW.rrrrrdW
WdW...W W  w  w ww   w  .rdddddW.rrrrr.W
WWW.WWW W w  w   w  ww  WdrrrrrW.rrrrrdW
W     W Wq         w  qwWdddddd..rrrrr.W
W .d. W WWWWWWWWWWWWWWWWWWWWWWWWWWWrrrdW
W dWd W .rW      WrWq    WWW.d.d.d.drr.W
W .d. W ..W WWWW WrW W W WWWdWWWWWW.rrdW
W dWdqW ..wqW  W WrW W WqWWW.  q  Wdrr.W
W .d. W ..WqWW W W.d.d.d.d.WdWWWWWW.rrdW
W dWd W ..Wqqq W WdW WqW W.W.   q Wdrr.W
W ... W WWrWWWWW WdW W W W.WdWWWWWW.rrdW
W    qW W..      WdWq    W.W.    qWdrr.W
WWWWWdW WdWWWWWWWWdWWWWWWW.WdWWWWWW.rrdW
WdddddW WdddrW...W.Wq...W..WddddddWdrr.W
WddrdrW WWWd.W....rqq...W.WrdrdrddW.rrdW
WdwqwqW WqWW W...WWWW...W.wqwqwqwdWdrr.W
WdwrwrW W WW W..........W.wrwrwrwdW.rrdW
Wd..... W    w.....P....X........dWd.d.W
WWWWWWWWWWWWWWWWWWWWWWWWWWWWWWWWWWWWWWWW
[/map]
[/cave]

[cave]
Name=Cave 2
CaveDelay=8
CaveTime=170
DiamondsRequired=30
DiamondValue=16 20
Colors=Black Black Cyan Purple Yellow

[map]
WWWWWWWWWWWWWWWWWWWWWWWWWWWWWWWWWWWWWWWW
WX          WWWWW....d.d...r....d....d.W
W .WWWWW WW WW  .W.d...WW  . r.WWWWWWWdW
W WPqWWW WW WW W Wr..r.  W d W W  q dW.W
W Wqqq   WW    W Wrr...W   W W WW W WW.W
W WWqWWW WW WW W W..d.  .WqW   q    WWdW
W WW WWW   dWW  dW..r.WWWW W WWWWWW  W.W
W WW WWWWW WW  W..r.r..    W  .W     ..W
W      WWW WW WW.r....W W. WWW W WWW WrW
W WWWW WWW    ...r.d.r. WW     W W d .dW
W WWWW    .W W..drr.d.rWWWW.WW q   ..r.W
W     dWW WW .r...........d...r...r..drW
WWWW WWWW   dW.r...r.r..rd..r....d..d..W
WWWW WW   W.W..r.W.W .W..rr..d.rr.r..W.W
WW      W....... W W W  ..r.....W.W q  W
WW WWW WW.rdr. W q  d  WW . W . WWWWW WW
WW.   d...r.WW . WW WW WW W W W WdWd  WW
W.WWWWW.r...d   WW   W   q  . W  .WW   W
W..rr.r.rd.WW W  W W   WWW WW WWWq   W W
Wd.....r..W W WW   W W   W WW W   WW W W
W..dr.d....  q WdWWW WWW W  d   W      W
WWWWWWWWWWWWWWWWWWWWWWWWWWWWWWWWWWWWWWWW
[/map]
[/cave]

[cave]
Name=Cave 3
CaveDelay=8
CaveTime=150
DiamondsRequired=60
DiamondValue=8 10
MagicWallTime=15
Colors=Black Black Gray3 Yellow White

[map]
WWWWWWWWWWWWWWWWWWWWWWWWWWWWWWWWWWWWWWWW
WdWrWdWrWdWdWrWdWdWrW.. r........drddrrW
WrWqWrWdWdWrWqWrWrW.... W.......WddrrddW
WrWdWdWqWrWrWdWdW......Wcr......WrdrddrW
WdWdWdWrWdWrWrW.......Ww W......WdrrdrrW
WqWdWrWdWdWdW........Wdw W....r.WrrddrdW
WdWrWrWrWrW.........Wddw W...rr.WdrdrdrW
WdWdWdWrW..........Wdddw W..rr..WWWW.WWW
WrWrWrW......WWWWWWWWWWWWW.rr...WdrrddrW
WdWdW........wr.q..wr.q.rw.r..M.WddrrrdW
WrW..........w.....w.....w...M..WrrddddW
W............w.....w..P..w..M M.WddrdrrW
W............w.....W.....W.M M..WdrrdrdW
W............w.....W.....W..M M.WrdrrddW
W............WWWWWWWWwwwWW.M M..WdrddrrW
W...........W..r.rrXqq   W..M...WWWW.WWW
W..........W.r.rrrrW ... W.M....W      W
W.........Wr.r..rrrW .d. W......W      W
W........W.rr.r.rrrW .d. W......W      W
W.....  Wrr..r.r.rrW ... WWWWWWWW      W
W.....qq...r.......W     ........      W
WWWWWWWWWWWWWWWWWWWWWWWWWWWWWWWWWWWWWWWW
[/map]
[/cave]

[cave]
Name=Cave 4
CaveDelay=8
CaveTime=220
DiamondsRequired=99
DiamondValue=4
AmoebaTime=175
Colors=Black Black Cyan Green Purple

[map]
WWWWWWWWWWWWWWWWWWWWWWWWWWWWWWWWWWWWWWWW
WXWdrrddrdddrdr.rddrdrdddWrrrrddrddddddW
WqWddddrdddrddrdddddrrdrdWrrddddrddrdrdW
WqWrdrddrdrdrdrdrdrddddrrWrddrdrrddrrddW
WqW..d.ddddddddrdddrddrddWrd.dddddddddrW
W Wrddrddrrrrdrd.ddddrdrdWdrdrrrdrdrdddW
W.Wddrdr.dWWWWWWW.WWWWWWWWrrddrdrd.drdrW
W.WWddd.ddW              WdddddddddrdrdW
W..Wr.rdd.               Wd.ddrrrdddrrrW
WW.WWWWWWWW              WdddddrdrdrrddW
W         r      W       WddrdrrrddddrrW
WWWWWWWWWWW             W.d.ddrddrdddrrW
W                      W...ddddrddd.dddW
W         W           W..WWWWWWWWWWWWWWW
W         W           ..WdrrdrddrddrrrdW
W         W           .Wrrddrdrrddrd.rdW
W    a    W           Wdd.drrddrrdrddddW
W         W           .d.dddddrdd.ddrrdW
W         W           WrddrdrdrrddrrddrW
W         W           Wdrdrdd.dd.rd..drW
WP    qqqqqq          WddrddrddrdrrdrddW
WWWWWWWWWWWWWWWWWWWWWWWWWWWWWWWWWWWWWWWW
[/map]
[/cave]

[cave]
Name=Cave 5
Intermission=true
CaveDelay=4
CaveTime=50
DiamondsRequired=15
DiamondValue=35 40
AmoebaTime=40
Colors=Black Black Green Purple Red

[map]
WWWWWWWWWWWWWWWWWWWW
WrddddrdrdddrrrddWqX
Wddrrrrr.rdrdddrdWqW
WddrddWWWW.WWWWWWW W
Wdrddd.      ......W
WWWWWWW      WWWWWWW
W.dddd.            W
WdrdrrW      W    qW
WrrdddW      W  a  W
Wdrdd.W      W    qW
WrddrdW           PW
WWWWWWWWWWWWWWWWWWWW
[/map]
[/cave]

[cave]
Name=Cave 6
CaveDelay=8
CaveTime=200
DiamondsRequired=80
DiamondValue=6 8
MagicWallTime=8
Colors=Black Black Blue White Cyan

[map]
WWWWWWWWWWWWWWWWWWWWWWWWWWWWWWWWWWWWWWWW
WWd.....rWd.rrrrWcccc.....r.r.r.r.r.r.rW
WW.WW W..W.WrrrrWc   ..................W
WW.WrqWW.W.Wrrrr.c   ....r.r.r.r.r.r.r.W
WW.WrrWW.W.WrrrrWcccc..................W
WW.W...W.W.WrrrrW......................W
WWd..WWWd.dWrrrrW......................W
WWWWwWWWWWWWrrrrW.r....................W
W        W.d.rrrW.r....................W
W        WrWd.rrW.wWWWWWWWWWWWWWWWWWWWWW
W   P    ..rWd...r.....................W
W        Wd.rWW.WWWWWWWWWWWWWWWWWWWWWW.W
W        Wrd.rW...r.r.r..W.............W
W q q q qWdWd.rWW w w wWdW.drdrdrdrdrd.W
WWWWXWWWWWddWd.rW W WcWW.W.rdrdrdrdrdr.W
WddrdrdrdrdrdWd.W W WWWWdW.............W
WddqdqdqdqdqddW.W WcWq  .W.MMMMMMMMMMMrW
WdwrwrwrwrwrwrW.W WWWWWWdW.rrrrrrrrrrrrW
WddqdqdqdqdqdqW.WcWq    .Wr............W
WdwrwrwrwrwrwrW.WWWWWWWWdWrrrrrrrrrrrr.W
Wd..............Wq      ...............W
WWWWWWWWWWWWWWWWWWWWWWWWWWWWWWWWWWWWWWWW
[/map]
[/cave]

[cave]
Name=Cave 7
CaveDelay=8
CaveTime=140
DiamondsRequired=99
DiamondValue=5
AmoebaTime=255
Colors=Black Black Red Gray3 White

[map]
WWWWWWWWWWWWWWWWWWWWWWWWWWWWWWWWWWWWWWWW
Wr r... . . .ddr....rr rq.drda.cd.dr.r.W
W.X d c.r.d.d ad.dr. d.d.r . .... . rdrW
W dP.dr.Wrr.. dq d.dr q..rdr.d.    ...qW
W.d.. ..Wardr.ddr.. r.d rdr d.d...d.d.qW
W....r..W rddddd..rr ..d.r. .   a...rddW
W..drd .W..adcd.Wd r ddr...drr.r.r ddadW
W.. d.c Wr. ddrdW  ...ard d..d..drrdcdrW
Wr...r..Wdd.a.r.W.d..r c.d. q..r ..rr rW
W.aad rdWd.  r. W..r.q. Wd d.r ..dr.r rW
Wrq..rr.W.d.dd..Wd.rr  .W.dd ddd.ddr. dW
Wd.ddrcd.r...drrW..rr  aWq..d.drr. ..r.W
W.rd.rd.d ...d .Wqr.c .qW..r dr W .   .W
Wd.ar rd..r .q..Wr.q d..W.aa  .dW.cd..qW
Wdcr.rrdd...d....rd. .d.W. rrd. Wr . . W
W.ardad .r..rrr.a.d...d W.a .r.dWr. .d.W
Wrr.dr dd.rda.r d..ddcddW...rrd Wr d.r.W
W. .d..r. .r.dr.d. dd r .. ...d W.r...rW
W.. r..crc r.a qr .. .aadr  d.r.W.r.radW
W.ac. ..d...d. r ....dr d..rrr. Wcr..d.W
W..r.a.ad.qddr r.rd..r..d.ard.drdr. q..W
WWWWWWWWWWWWWWWWWWWWWWWWWWWWWWWWWWWWWWWW
[/map]
[/cave]

[cave]
Name=Cave 8
CaveDelay=9
CaveTime=180
DiamondsRequired=90
DiamondValue=5 6
AmoebaTime=100
Colors=Black Black LightBlue Brown White

[map]
WWWWWWWWWWWWWWWWWWWWWWWWWWWWWWWWWWWWWWWW
Wa                 aa                 aX
W wwwwwwwww wwwwwwwwwwww wwwwwwwww www W
W w.r.r. r..r.. r..r rrrr.....r.r....w W
W w.r ...r.. .r..... ...r... ..rr..r.w W
W w....  ...  r...r...rr..r.......r..w W
W w rr...........r. ....r ..... ... .w W
W  r.r...r.r...r......r..rr... ..r.  w W
W w..r..r.r.r.......r..... r.r.r..rr.  W
W w.rrr....r..r... r..r .. .... r....w W
W wr.....r... r ....r ...r... ....  rw W
W wr. ....r.... ...rrr. ....   .....rw W
W  .... .. rr.r.....P..r...r... r.r. w W
W w .r.. ....r . .r.r.rr.r .r..r...r.w W
W  .....r........rrrr.r.r. .r .. r.  w W
W wr. ....r .r.r. r. . rr.r.r. .....   W
W wr.. r....r....  .r....r.....r...r.w W
W wrr ...r........ r... .r.r.r....r..w W
W w....r..r.r .r.r.....r...r  r.r...rw W
W www wwwwwwwwwwwwwwwwwww wwwww wwwwww W
Wa                 aa                 aW
WWWWWWWWWWWWWWWWWWWWWWWWWWWWWWWWWWWWWWWW
[/map]
[/cave]

[cave]
Name=Cave 9
CaveDelay=8
CaveTime=160
DiamondsRequired=50
DiamondValue=10 15
MagicWallTime=150
Colors=Black Black Brown Gray2 Yellow

[map]
WWWWWWWWWWWWWWWWWWWWWWWWWWWWWWWWWWWWWWWW
W...r...rr .. .. r .r.r.... ..r.q....rrW
Wr. ............r.r.........r. ..rr..r.W
W... .. ..r....... ....q . ....r...r...W
Wr....MMMMMMMMMMMMMMMMMMM .... ...rr...W
W....rMr......r.... ...qM..MMMMMMMMMMM.W
WMMMr.M.............. ..M.......... . .W
Wq.. .M..rr......r.q.c..M..rc..r. .....W
W. ...M q...r... ..r..r.M.r.r.r.. .....W
W.. . M.. .r.r PX... ...M........r.q...W
W...r.M..rr....r....q...M........ r..r.W
W....rM. ...... .c..rr .M. .r...r.r.r.rW
W..r..M ....rrr..r......M.....M..r..rc.W
W.r .rM.. ....... ..... M....M..... cr.W
W.....MMMMMMMMMMMMMMMMMMMr..M..........W
W.c......... r......r......M...MMMMMMM.W
WMMMM............r.r c....Mrrr rr.. q..W
W................r.. ....M..r..r. ... .W
W.q...r. .r....q...... .M.............rW
W.  ..r .rr............M. r.. .....r...W
W... .r..c.r.......r........ q.q.r..rr.W
WWWWWWWWWWWWWWWWWWWWWWWWWWWWWWWWWWWWWWWW
[/map]
[/cave]

[cave]
Name=Cave 10
Intermission=true
CaveDelay=5
CaveTime=40
DiamondsRequired=10
DiamondValue=40 50
MagicWallTime=35
Colors=Black Black Orange Yellow White

[map]
WWWWWWWWWWWWWWWWWWWW
Wr.. r...c.r..rr.  W
W..MMMMMMMMMM ...r.W
W rMr. .r.rrMrr.r..W
W .Mq..PX..rM... M.W
W..M .r.. ..M.r Mr.W
Wr.MMMMMMMMMM..M..rW
W........r ...M....W
WMM .r.r.....M..r .W
W ...r.. .r.M. r..rW
W.r.r.  .rr....r.q.W
WWWWWWWWWWWWWWWWWWWW
[/map]
[/cave]

[cave]
Name=Cave 11
CaveDelay=8
CaveTime=200
DiamondsRequired=50
DiamondValue=10 12
AmoebaTime=70
MagicWallTime=10
Colors=Black Black Orange Green Red

[map]
WWWWWWWWWWWWWWWWWWWWWWWWWWWWWWWWWWWWWWWW
Ww..............w...Wqqqqq ........rrWrW
Ww.arararararar.w.W.WWWWWWW.rWWWWW....qW
Ww.rararararara.w.W.rrrrrrW.wdr..WWWWWrW
Ww.arararararar.w.W.wcwcwcW.WrdWdrdrdWrW
Ww.rararararara.w.W.rrrrrrW.WdrWdrdrdWrW
Ww.arararararar.w.W.wrwrwrW.WrdWdrdrd..W
Ww.rararararara.w.W.rqrqrqW.WdrWWWWWWW W
Wwrrrrrrrrrrrrrrw.W.wrwrwrW.W..W     W W
W.................W.........W.rW WqW WWW
W.MMMMMMMMMMMMMMWWWWWWWWWWWWW... q W .PW
W.              WrW q q q q qWWW WWW WXW
W.              ..WWqWWWqWWWqW W    qW.W
W.              W..WqWWWqWWWqW.WWWWWWW W
W.              .W.WqrWWqrWWqW w.d wdw.W
W.              .W.dq.ddq.ddq..d w.w. dW
W.              .W.WqWWWqWWWqWwww.dwww.W
W.              ..WW WWW WWW Ww.. w .d W
W.              ..WW WWW WWW W.dww.dw.wW
W.              ..WW WWW WWW W w w w .wW
W.              ..W q   q   qW. .d.wwdwW
WWWWWWWWWWWWWWWWWWWWWWWWWWWWWWWWWWWWWWWW
[/map]
[/cave]

[cave]
Name=Cave 12
CaveDelay=8
CaveTime=150
DiamondsRequired=99
DiamondValue=5 6
AmoebaTime=130
MagicWallTime=30
Colors=Black Black Purple Red Yellow

[map]
WWWWWWWWWWWWWWWWWWWWWWWWWWWWWWWWWWWWWWWW
Wcqcqc       WdWcWrWdXqWdWdWrW aaaaaaaaW
Wq...q       WrWrWdWcWrWcWrWqW     aaaaW
Wc.P.c       WdWrWrWdWrWrWdWrW         W
Wq...q       W.W.W.W.W.W.W.W.W   d     W
Wcqcqc                                 W
W                       d   r dr   d d W
W                         r   r        W
W                     d   d      dr W  W
W   rdrd       rdrd      r  W   d   WrdW
W   ....       ....         W  W  WWW  W
W                      rWWWWW rW    W  W
W                          d r W r  rr W
W                     d d r   dW  W   dW
W MMMMMMMM   MMMMMMMM  d W   d W  W  r W
W .  c  q.   .c  q  .  r W r WWW rWd   W
W . c    .   .    c .    W r d  r W    W
W . q  c .   .q c   .   rW        W  d W
W .  q   .   . c    .    WWWWWr d W r  W
W .c c   .   .cc  cq.  d  d    r      dW
Wc. c   c.ccc.      .       d      d   W
WWWWWWWWWWWWWWWWWWWWWWWWWWWWWWWWWWWWWWWW
[/map]
[/cave]

[cave]
Name=Cave 13
CaveDelay=8
CaveTime=30
DiamondsRequired=6
DiamondValue=80
Colors=Black Black Yellow Purple Green

[map]
WWWWWWWWWWWWWWWWWWWWWWWWWWWWWWWWWWWWWWWW
WwwwwwwwwwwwwwwwwwwwwwwwwwwwwwwwwwwwwwwW
Ww.w...w...ww.......w..ww.....w...w...wW
Ww...w...w....w.w.w......wwww...w..ww.wW
Wwww..w.w.ww.w.w.w.w.www.....w.ww.....wW
Www....w....w....w.ww...wwww..w..w..w.wW
Ww..www..ww....ww.....w.....w.....w..wwW
Ww.w.w..w..www...w.ww..ww.w..w..ww.w.wwW
Ww.w...w..ww..w.ww...w..ww.w..w..ww...wW
Ww..ww..w...w.w..w.wPww.....ww.w.w..w.wW
Www...w..w.ww.ww....w..www.w.......w..wW
Www..w..w.......www.......w..w..www.w.wW
Www.w..w..wwww....ww.wwww.w.www..w....wW
Ww..w.w......wwww...w....w..w..w.w.w..wW
Www.w..w...w....ww...w.w...w..w.....w.wW
Www..w..ww..w..w...w...w.w.w.w.w..w..wwW
Ww.w..w...w..w..wwww.www..ww....w.wwwwwW
Ww..w....w....w.....w...ww...ww.w.wdddwW
Www...w.w..w.w....www.w..w.wwww..wwdddwW
Ww..w..ww.ww..w.w......w......w...   XwW
WwwwwwwwwwwwwwwwwwwwwwwwwwwwwwwwwwwwwwwW
WWWWWWWWWWWWWWWWWWWWWWWWWWWWWWWWWWWWWWWW
[/map]
[/cave]

[cave]
Name=Cave 14
CaveDelay=8
CaveTime=100
DiamondsRequired=99
DiamondValue=3 4
Colors=Black Black Purple Cyan Yellow

[map]
WWWWWWWWWWWWWWWWWWWWWWWWWWWWWWWWWWWWWWWW
Wrcr.r.crccqccrrcqr.rrrrr.rrrrc.qrcrqccX
Wcqqr.rrc.ccrcrqccrc.rcrqrrc.r.rqrcrcrcW
W.rqcrcqccrcrrcrqccrcrcccqccqrrcrcrqcccW
Wcqcrcrc.rqcrrqcrqqcccrcrrrcrq.crqq.rqrW
Wrccqcccqcrcrqrrrrrrqrcqcrcrcrrcqr.rc.qW
Wqrcrrccqrrqrcqrqcc.rcrcrcrccrcrrrrcc..W
Wrrrrrccqrrq.rrccrqqqcrrqqqqcrrqrc.rrcqW
Wrrrqcccrccqccccrrrrc.rrqrrrc.crrrrr.qqW
Wrrc.r.ccqrq.crrrrrrrrcccrrrrrqrr.rcrr.W
Wc.rqrrrrr.crccrrrcqqccccrcrcrqcrccrrrrW
Wr.r.rrrqr.c.ccc.rrrccr.rrrqrrrcrrrcrcrW
Wcrrcqrqrcrqrccqrrccrcrqcqcrcrrrcqrcrq.W
Wrqrcrrc.ccr.rqrrrqrqrrcrrrrqc.qrrrcrqrW
Wc.qc.rrcrqrqrcqrrrrq.rc.rcqrcq.rrrrrrrW
Wqcc.rcqqrqqcrrcrcrqqqrrqrrc.rrqrrrcqqrW
Wrcrqcrrrcrrrcrrccc.c.ccrcrrccrrqrc.rrrW
Wqrqcr.crr.qcrrqcrq.rrrrr.cccrcrrcrqrq.W
WrrrrrrrrrrrrrrrrrrrrrrrrrrrrrrrrrrrrrrW
WP.....................................W
W......................................W
WWWWWWWWWWWWWWWWWWWWWWWWWWWWWWWWWWWWWWWW
[/map]
[/cave]

[cave]
Name=Cave 15
Intermission=true
CaveDelay=5
CaveTime=30
DiamondsRequired=40
DiamondValue=12 15
Colors=Black Black Red Orange White

[map]
WWWWWWWWWWWWWWWWWWWW
Xqrrrc.rqrrrrcrrrrrW
WrrqrrqrrrqrrrrqrqqW
Wrqrqrcrrcrqrq.rc.rW
WrcrrrcqrrcqqcrrrcrW
Wccqqrr.cqrrccrcrrcW
WrrcrrqrcrccrcrrcccW
Wqrccqrccrcr.rqcrqrW
WrrrrrrrrrrrrrrrrrrW
W.................PW
W..................W
WWWWWWWWWWWWWWWWWWWW
[/map]
[/cave]

[cave]
Name=Cave 16
CaveDelay=8
CaveTime=200
DiamondsRequired=99
DiamondValue=4 5
AmoebaTime=180
Colors=Black Black Yellow LightBlue Green

[map]
WWWWWWWWWWWWWWWWWWWWWWWWWWWWWWWWWWWWWWWW
Waaa.aaa.aa......rPWWWW WccccccccccccccW
W................W..WWW W              W
W................Ww..WW Wrr rrr rrr rr W
W............c....Ww..Xq...r...r...r...W
W................c.Ww..r W...W...W...W.W
W.c....c............WWWWWWWWWWWWWWWWWW.W
W........c...c..........c.c............W
W..c................c..................W
W.......c......c....................c..W
W.............c......c......c....c.....W
Wc....c.............c.........c..c.....W
W.........c......c.....................W
Wc..c.c..............c...c...........c.W
W...........c......c...................W
W........c.................c...cc......W
W.........c....c................c.c....W
W......c................cc......c......W
Wc...c.c.............c..c.............cW
W............c.c.......................W
W..c...c....................c.....c....W
WWWWWWWWWWWWWWWWWWWWWWWWWWWWWWWWWWWWWWWW
[/map]
[/cave]

[cave]
Name=Cave 17
CaveDelay=8
CaveTime=200
DiamondsRequired=99
DiamondValue=4 5
AmoebaTime=255
Colors=Black Black Purple Gray3 Green

[map]
WWWWWWWWWWWWWWWWWWWWWWWWWWWWWWWWWWWWWWWW
W.....................................PW
W.....c..........W WWWWW.....c.........W
Wc.......WWW WWWWWaaaaaWWWW............W
W........  aaaaaWWaWWWaaaaW............W
W.......cWWWWWWaaaaW.WWWW  ..WWWW......W
W.............WWWWaWW...WWW.WWa  ..c.c.W
W............c...WaaW......cWaaWW......W
W....WWWWWWWWWWW.WWaWWWWWW..WaWW.......W
W..c. aaaaaaaaaWWWXaWWaaaWWWWaWWWW.....W
W.c..WWWWWWWWWaaaaaaaaaWaaaWWaaa  .....W
W............WWWWWWaaWWWWWaaaaWWWW....cW
W.....c.........WWWWaWc..WWWWWW........W
W.......W W....WWaaaaW.......c.........W
W.....WWW W....WaaWWaWWWWW.....WWWW....W
W...c. aaaW.c..WaWWWaaaaaWWWWWWWa  ....W
W.....WaWWWWWWWWaWWWWWWWaaaaaaaaaWW..c.W
W.....WaaaaaaaaaaaW.WWWWWWaWWWWWWW.....W
W.....WWWWWWWWWWW W.WaaaaaaW...........W
W...............W W.W WWWWWW..........cW
W.c.............c....c......c..........W
WWWWWWWWWWWWWWWWWWWWWWWWWWWWWWWWWWWWWWWW
[/map]
[/cave]

[cave]
Name=Cave 18
CaveDelay=8
CaveTime=200
DiamondsRequired=10
DiamondValue=50
Colors=Black Black Green LightRed White

[map]
WWWWWWWWWWWWWWWWWWWWWWWWWWWWWWWWWWWWWWWW
WX.r...r.q.r.rrr.r.qrr..r.r..qrrr.r.r.rW
W..rr.rrrwrrrrrrrr.wr.rrrrrrrwr.rdrrrr.W
Wrdr.r.rrw.r.rrrrrrwrr.rr.rdrwrr..r.rr.W
Wr.rrrr.rwrrrdr.rr.w.rrr.rrr.w.rrrrr.r.W
W.rr.rdr.wr.rrrrr.rw.r.rrrdrrwr.rrrrrrrW
W.rrr.r.rw.rrr.rrrrwrrr.rrr.rw..rrrrrrrW
Wwww.wwwwwwwww.wwwwwwwww.wwwwwwwww.wwwwW
W                                      W
W                                      W
W                          q q q q q q W
Wwww.wwww.wwww.wwww.wwww.wwww.wwww.wwwwW
Wr.rrr.rwqwrd.r.r.wqwrrdrrrrwqwrrrrr.rwW
W.r.rdrrwqwrrrrrrrwqwrrrrrrrwqw.rrr.r.wW
Wrrrr.rrw wrrrrrr.w w.rrrrr.w wrr.rrdrwW
Wrrr.rr.w wrr.rrrrw wrrrrrrrw wr.r.rrrwW
Wrrr.r.rw w.rrr.r.w wrrrrrr.w wrrrr.rrwW
Wwww.wwww.wwww.wwww.wwww.wwww.wwww.wwwwW
W......................................W
W......................................W
W..................P...................W
WWWWWWWWWWWWWWWWWWWWWWWWWWWWWWWWWWWWWWWW
[/map]
[/cave]

[cave]
Name=Cave 19
CaveDelay=8
CaveTime=160
DiamondsRequired=24
DiamondValue=20 25
Colors=Black Black Red Gray1 Yellow

[map]
WWWWWWWWWWWWWWWWWWWWWWWWWWWWWWWWWWWWWWWW
WPrw. .q.......r ....... rq...... ....rW
W..wrr.rr. .d.....r. ....r..d.W..r.r . W
W..wr...r...r  r..rr. W..WWWWW.W.... d.W
W..wr ....W.... ..WWWW.WW. ....rWWrrqr.W
W..w....WW.WWWW..Wr.. ......qr r.Wr...rW
W..w .. q.. ...WW....d..r....... .W....W
W..w.r.q ..r.. ....r.d rr.WWWr.dr .WW .W
W..w... q..... d.r.. d..rW. r...r..dWr W
W..w..WWW..WWW..rr...WWWW W. .. r .rWr.W
W..wrWX .WW...WW.r .W...r.WWd.r.....Wr.W
W..w.W.qd..d.  .WW.W.. r. .W... .r.W.. W
W..w W. ...r.. rr.W d..r..W. .dd...W...W
W..w.W..r. .......r.d..  .W.. .....W. rW
W..w..W .r. dr.rr.... d .. .r..r .W. .rW
W..wrd WWr.q.r.Wrd. ..r..d ....rr..W. .W
W..wr...WWW.r.W.WWW.....r.q  .WWWW.Wr. W
W..w. .r...WWWW.d rWW..r.WqWWW.rr.W....W
W..w.... . .... . r.WWWWW.W... .rr..d.rW
W..w r.. r... .r...r.q .r.d. ...r.... .W
Wq.w . ..rr...r... .  ....rd..r.. .r..rW
WWWWWWWWWWWWWWWWWWWWWWWWWWWWWWWWWWWWWWWW
[/map]
[/cave]

[cave]
Name=Cave 20
Intermission=true
CaveDelay=5
CaveTime=30
DiamondsRequired=7
DiamondValue=70
Colors=Black Black Gray3 Purple Cyan

[map]
WWWWWWWWWWWWWWWWWWWW
WPrw.r .r. d...r .dW
W..w..... ..WW.W  rW
W..w. qW.rWW.rWXW..W
W..w.q .WW.d.  .W. W
W..wrW... .r...d.W.W
W..w..W.r....r..rW.W
W..w.rWd.rq WW. W. W
W..w ..W.WWW.WW.W rW
W..w. d.W.r. ..W. rW
Wq.wr ... r.r. d  .W
WWWWWWWWWWWWWWWWWWWW
[/map]
[/cave]

[/game]

[/BDCFF]