; Converted using Tim Stridmann's X2BDCFF converter.
; Last modified: 14 June 2006

[BDCFF]

[game]
Name=Arno Dash 4
Date=January 2003
Author=Arno Weber
WWW=http://www.boulder-dash.nl/
Charset=Original
Fontset=Original
Levels=1
Caves=20

[cave]
Name=Cave 1
CaveDelay=8
CaveTime=120
DiamondsRequired=45
DiamondValue=8 10
Colors=Black Black Orange LightRed White

[map]
WWWWWWWWWWWWWWWWWWWWWWWWWWWWWWWWWWWWWWWW
WP..d......r ...... .dd .........rrr..rW
W.X.r.rr.  q.. r..r ......r.. .d..r ...W
W......r.d...d..r.....r . ....r... .d.rW
W.r ....rq .r.qd..r.....  ..r....r. .r.W
W.... ..d.. .rq ...r....... ....r...r.dW
W...r...d  ...d. ..q... r..r..... ..r..W
Wr.d........... .dr..r ..... .... .....W
W...q.d.qd.. qd. .....rd...q......dr. .W
W.d..r.....r rd.. .. .....r .....rqr ..W
W.d.. ......d.....r...d... ... .. .....W
W.. q.r..d...d... d..............r....rW
W.d .d..d.......d.d. .r.. . .r......d..W
W..r.dd....r....r . ....r...r...d......W
Wr ............... ...q ...dd....r.....W
W..rr...r .r.r..... r.... ....r ..d..d.W
W...d.r.rr.. . ..............r..r..dr.dW
W..d. .r d. .rq .d.......r.q. r.r. dq rW
W...d.. d.  ....r..r ..r..r.r.... .....W
W...... .......r...............r. rr..rW
Wqd... ......d.d........ .d..d .r.qd.rqW
WWWWWWWWWWWWWWWWWWWWWWWWWWWWWWWWWWWWWWWW
[/map]
[/cave]

[cave]
Name=Cave 2
CaveDelay=8
CaveTime=120
DiamondsRequired=14
DiamondValue=20 25
Colors=Black Black Purple Green White

[map]
WWWWWWWWWWWWWWWWWWWWWWWWWWWWWWWWWWWWWWWW
W........r.rr...........d..rr..........W
W..      .....r..      ...rrr..      ..W
W.. .... .d..r... .... .r...r.. .... ..W
W..     q...r.rdr     q.....d.d     q..W
W.......... ....r.........rr...........W
WW WWWWWW.d.r..drWWWWWWrr.r..r.WWWWWW WW
WW WWWWWWWWWWWWWWWWWWWWWWWWWWWWWWWWWW WW
WW WWWWWWr.d.rr..WWWWWW.....d.rWWWWWW WW
W........r....r.r......d.r.r...........W
W..      ..r..drr      ....r..d      ..W
W.. .... .r...... .... ...rr... .... ..W
W..     q...r.dr.     qrr...drr     q..W
W........d..d...........r..rrrr........W
WW WWWWWWWWWWWWWWWWWWWWWWWWWWWWWWWWWW WW
WW WWWWWWWWWWWWWWWWWWWWWWWWWWWWWWWWWW WW
WW WWWWWWWWWWWWWWWWWWWWWWWWWWWWWWWWWW WW
WW WWWWWWWWWWWWWWWWWWWWWWWWWWWWWWWWWW WW
WW WWWWWWWWWWWWWWWWWWWWWWWWWWWWWWWWWW WW
WW WWWWWWWWWWWWWWWWWWWWWWWWWWWWWWWWWW WW
WWPq                                q XW
WWWWWWWWWWWWWWWWWWWWWWWWWWWWWWWWWWWWWWWW
[/map]
[/cave]

[cave]
Name=Cave 3
CaveDelay=8
CaveTime=200
DiamondsRequired=99
DiamondValue=4 6
AmoebaTime=160
Colors=Black Black Blue Gray2 Green

[map]
WWWWWWWWWWWWWWWWWWWWWWWWWWWWWWWWWWWWWWWW
Wcccccccccccccccccccccccccccc          W
Wcccccccccccccccccccccccccccc          W
W......................................W
W......................................W
W......................................W
W......................................W
W......................................W
W......................................W
W......................................W
W......................................W
W......................................W
W......................................W
W......................................W
W......................................W
W......................................W
W............................r.........W
W.............................r........W
W..............................r......PW
W.a....a....a....a....a.........r......W
W................................r.....X
WWWWWWWWWWWWWWWWWWWWWWWWWWWWWWWWWWWWWWWW
[/map]
[/cave]

[cave]
Name=Cave 4
CaveDelay=8
CaveTime=160
DiamondsRequired=30
DiamondValue=12 16
Colors=Black Black Red Cyan White

[map]
WWWWWWWWWWWWWWWWWWWWWWWWWWWWWWWWWWWWWWWW
W.......r.....r.w..r...w               W
W.r....rw.......w.....Xwr  wwwwwwwwwww W
W...r...w....r..w.rr...w.  wwwwwwwwwww W
W.......w.r.....w......w   wwwwwwwwwww W
Wqqqq   wqqqq   wqqq   w.  wwwwwwwwwww W
W.r.....w.....rrw......w   wwwwwwwwwww W
W.....r.w.......w...r..w   wwwwwwwwwww W
W..r....w..r..r.w......w   wwwwwwwwwww W
W...r...w.............rw   wwwwwwwwwww W
W.wwwwwwwwwwwwwwwwwwwwww  cwwwwwwwwwww W
Wr..................r.rwr qwwwwwwwwwww W
W...r........r..r......w. cwwwwwwwwwww W
W...........r.r.r......w  qwwwwwwwwwww W
W...................r..w  cwwwwwwwwwww W
W.r.............r......w. qwwwwwwwwwww W
Wr...r.......r.........w  cwwwwwwwwwww W
W..r...r.rr.r..........w  qwwwwwwwwwww W
Wr............r...r..r.w  cwwwwwwwwwww W
W.........r............w  qwwwwwwwwwww W
W....rrr..r........r...w. cP           W
WWWWWWWWWWWWWWWWWWWWWWWWWWWWWWWWWWWWWWWW
[/map]
[/cave]

[cave]
Name=Cave 5
Intermission=true
CaveDelay=3
CaveTime=30
DiamondsRequired=15
DiamondValue=35 45
Colors=Black Black Green Blue White

[map]
WWWWWWWWWWWWWWWWWWWW
W c c.w....rq....r.W
W ww rwXrr..q......W
W ww .wwwwwwwwwww..W
W ww  wrr..r..r....W
W ww  w.......r..r.W
W ww  w.....r......W
W ww  w.r........r.W
W ww  w............W
W ww  w....r....r..W
W    Pwr...........W
WWWWWWWWWWWWWWWWWWWW
[/map]
[/cave]

[cave]
Name=Cave 6
CaveDelay=8
CaveTime=220
DiamondsRequired=80
DiamondValue=6 8
Colors=Black Black LightBlue Red White

[map]
WWWWWWWWWWWWWWWWWWWWWWWWWWWWWWWWWWWWWWWW
W..r..r r.. .c.w. .r. .r...r ... w rr. X
W  r. w. c .r..wr  ..r..w.c. .c.rw.r...W
W. ...w....r r.w.r  .r .w.r..r. .wr. . W
W...r.w... . . w . .rr.rw .. ..c.w..r. W
W. ...wc.r.rrr.w.r .r..rw.rr r..cwc. r.W
Wr....w.r..r . w ..... .w..... ..w ..c.W
W..cr w.. ...c.w.r.c ...w. .r....w . ..W
Wr r..w ....  rwrr. ..c.w  r.c .cw.rr. W
W .. .w  r. . .w....  ..w. .r.rc w..r..W
W.c..cw.rr.....wr. .r.. w   r. . w  . .W
Wrr .rwrr. r .rwrr...r.rwr .. .r.w. ..rW
W.r  rw..rr.. .wr. rr ..w. .r .  wc...cW
W r . wc... r .w.... cc.w .rrrr.rwr. . W
W. .crw.  . .. wrr.  .r.w. .c...rwr..r.W
Wrr r.w...r   .w.r..... wr...c. .wc.   W
Wrr ..w ... r. w .. r...w...rr .cw.. . W
W.r. .w. c...c.w.r  .. .wr ..... w .r..W
W. r.cwr .c....w ....r..w.rc...r w... .W
W   ..w.. ... .w...r..r w c . .. wc .c W
W P. .wrcrr .r....c .r..w...c . ..r .rrW
WWWWWWWWWWWWWWWWWWWWWWWWWWWWWWWWWWWWWWWW
[/map]
[/cave]

[cave]
Name=Cave 7
CaveDelay=8
CaveTime=140
DiamondsRequired=80
DiamondValue=6 8
Colors=Black Black Blue Gray3 White

[map]
WWWWWWWWWWWWWWWWWWWWWWWWWWWWWWWWWWWWWWWW
W..d..d d.. .q.w. .d. .d...d ... w dd. X
W  d. w. q .d..wd  ..d..w.q. .q.dw.d...W
W. ...w....d d.w.d  .d .w.d..d. .wd. . W
W...d.w... . . w . .dd.dw .. ..q.w..d. W
W. ...wq.d.ddd.w.d .d..dw.dd d..qwq. d.W
Wd....w.d..d . w ..... .w..... ..w ..q.W
W..qd w.. ...q.w.d.q ...w. .d....w . ..W
Wd d..w ....  dwdd. ..q.w  d.q .qw.dd. W
W .. .w  d. . .w....  ..w. .d.dq w..d..W
W.q..qw.dd.....wd. .d.. w   d. . w  . .W
Wdd .dwdd. d .dwdd...d.dwd .. .d.w. ..dW
W.d  dw..dd.. .wd. dd ..w. .d .  wq...qW
W d . wq... d .w.... qq.w .dddd.dwd. . W
W. .qdw.  . .. wdd.  .d.w. .q...dwd..d.W
Wdd d.w...d   .w.d..... wd...q. .wq.   W
Wdd ..w ... d. w .. d...w...dd .qw.. . W
W.d. .w. q...q.w.d  .. .wd ..... w .d..W
W. d.qwd .q....w ....d..w.dq...d w... .W
W   ..w.. ... .w...d..d w q . .. wq .q W
W P. .wdqdd .d....q .d..w...q . ..d .ddW
WWWWWWWWWWWWWWWWWWWWWWWWWWWWWWWWWWWWWWWW
[/map]
[/cave]

[cave]
Name=Cave 8
CaveDelay=8
CaveTime=230
DiamondsRequired=70
DiamondValue=7 10
AmoebaTime=100
Colors=Black Black Yellow Orange Green

[map]
WWWWWWWWWWWWWWWWWWWWWWWWWWWWWWWWWWWWWWWW
W....rdr.r rrr..r..rr..rr...rr...rr..r.X
W.. r...d.rr..r ..r.....r.wr.r.r.d...rrW
W.rr.......r  ...r......r.w r.rrr..rd.rW
W....r..r... ... .d.rr....w.r.....r.rrrW
Wrr...rrrr.r.r r. ........wr.r.r.rr..rrW
Wr.....dr. .r.r.r.rr.r....wr .r. r. .r.W
Wr...d.r.....r.r.r.rrd..r.w. dr...rdr.rW
Wrr.r r.r..rrrrrr.r.r.rr..wr.rr..r r.r.W
W. .r r....r. .r.rrr......w..r..rrr.r..W
Wdrr........r..rrrr.r ....wrr.r.rrr.r.rW
Wr.d.r.dr......r..rr..rrr.w.r....P....rW
W...r d.rrra...r.rr.r..rr.w..rr..r.rr.rW
W.. .rr...r.... rr...r.r..wr..r.rr r.r.W
W..rrrr.r....r...r. .. ...w...drr...rr W
W..r.r...d...r...... .....w..r.r..r.r.dW
W...r.r r.  r..r.... .r. .w.r.. r..r.rdW
W.. .r.rrr.r. ....r..r.r .w .r....r rd.W
W.r..... . .r...r....r..r.wr... r...r.rW
Wr.r.rrd.r... ..........r.wd.r rr.r...rW
W.rr...r. .dr.r.r.d.rr. r...r.rrr..r.rrW
WWWWWWWWWWWWWWWWWWWWWWWWWWWWWWWWWWWWWWWW
[/map]
[/cave]

[cave]
Name=Cave 9
CaveDelay=8
CaveTime=180
DiamondsRequired=34
DiamondValue=16
MagicWallTime=25
Colors=Black Black Gray2 LightGreen White

[map]
WWWWWWWWWWWWWWWWWWWWWWWWWWWWWWWWWWWWWWWW
W..wr.r..w.....w.....w.....w.....w....PW
W..wq..r.wr....wr....wr....wr....wr....W
W..wr.d.rwq.d..wq.d..w..d..w..d..w..d..W
W..w.....wr....wr....w ....w ....w ....W
W..w.....w.....w.....wq....wq....wq....W
W..wMMMMMwwwwwwwwwwwwwwwwwwwwwwwwwwwwwwW
W.rw.....w..r..w.....w.....w..r..w.....W
W..w....rw.r.r.w.....wr....w...r.w....rW
W. w..d..wr.d.rw..d..w..d..w..d.rw..d..W
W.qw.... w.....w.....w ....w.....w.... W
W..w....qw.....w.....wq....w.....w....qW
WwwwwwwwwwMMMMMwwwwwwwwwwwwwMMMMMwwwwwwW
W.qw.....w.....w..r..w.....w.....w.....W
W..w....rw....rw.r.r.w.....w.....wr....W
W..w..d..w..d..wr.d.rw..d..w..d..w..d..W
W..w.... w.... w.....w.....w.....w.....W
W..w....qw....qw.....w.....w.....w.....W
W..wwwwwwwwwwwwwMMMMMwwwwwwwwwwwwwwwwwwW
W........w.................w...........W
W........w.................w...........X
WWWWWWWWWWWWWWWWWWWWWWWWWWWWWWWWWWWWWWWW
[/map]
[/cave]

[cave]
Name=Cave 10
Intermission=true
CaveDelay=4
CaveTime=40
DiamondsRequired=12
DiamondValue=30
MagicWallTime=4
Colors=Black Black Gray1 Purple White

[map]
WWWWWWWWWWWWWWWWWWWW
Wrrrwr.rrwr...wr..PW
W...w....w....w....W
W.d.w .d.w .d.w .d.W
W...wq...wq...wq...W
WMMMwMMMMwwwwwwwwwwW
W...wr...w....w..r.W
W.d.wq.d.w..d.w....W
W...wr...w....w.. .W
W...w....w....w..q.W
WwwwwwwwwwwwwwwwwwwX
WWWWWWWWWWWWWWWWWWWW
[/map]
[/cave]

[cave]
Name=Cave 11
CaveDelay=8
CaveTime=200
DiamondsRequired=65
DiamondValue=8 10
Colors=Black Black Gray1 LightBlue White

[map]
WWWWWWWWWWWWWWWWWWWWWWWWWWWWWWWWWWWWWWWW
Wqqqq       .r.rWqqqqq    ......rwdddddW
W .r.d...d.  w.rWrrddrdrdrWd.....w....dW
W ......rr.. w.rWddddddddrWd.....w....dW
W ..rr.d.... w.rWdrrddddrdWd.....w....dW
W ..rr.rd.r. w.rWwwww.wwwwWd.....w....dW
W .d.r.rd.d. w.rWrdrrdrrdrWd.....wr...dW
W ..r.d...r. w.rWdrdrddrrdWd.....w....dW
W .......... w.rWddrddrrrrWd.....w....dW
W            w.rWrdrrrdrdrWddddddw....dW
WW.Wwwwwwwwwww.rWwwww.wwwwWWWWWWWWwwwwwW
WW.W.......d.w.rWrrdrrdrrrW............W
WW.r......dw.w.rWdrrdrddrdW............W
WWWrw....dw..w.rWrdrrdrrddW...ddddddd..W
W...w...dw...w.rWddrrrdrrdW...drwrwrd..W
W.WWw..dw....w.rWwwww.wwwwW...dwqqqwd..W
W. qw.dw.....w.rW         W...drqXqrd..W
W. qwdw......w.rW         W...dwqqqwd..W
W. qww.......w.rW         W...drwrwrd..W
W.  w........w.rW         W...ddddddd..W
W...........Pw...  q q q qW............W
WWWWWWWWWWWWWWWWWWWWWWWWWWWWWWWWWWWWWWWW
[/map]
[/cave]

[cave]
Name=Cave 12
CaveDelay=8
CaveTime=130
DiamondsRequired=30
DiamondValue=14 18
AmoebaTime=120
Colors=Black Black Gray1 LightRed Yellow

[map]
WWWWWWWWWWWWWWWWWWWWWWWWWWWWWWWWWWWWWWWW
W..ww........w....w.ww..d....w..ww.w..wW
WdwX...w...w.......w....w....d...w.d.w.W
W.wP.....w......wddww.w.........w..w..wW
Ww...w.....w...w.www..w...w..w...w.dw..W
Ww...w.....d.ad...w.ww..w.....w.w...wd.W
W........w....w....wwww.ww.w...........W
W..w.....ww.w.....www......w.w..ww.....W
Wwwwww.w...ww.........ddww...w.....d...W
Wd...........w....ww...ww...w.......w.wW
W..d...w.ww...w..wwd..wdwww.w.www.d..d.W
Www.wd....w...w.......w....w..w........W
Ww....w.w...w......w...w......wwwd...w.W
Ww.w.w..www.............ww..ww........wW
Ww..w..wwa.......dw..www....w..ww.w..w.W
W...d......w.ww.ww........w..ww.ww.....W
W.w......w....w....w..w..www...wa..w.w.W
Ww..ww.dw..d..w.www..ww.w..ww......ww..W
W.w...w.....ww.w...w.dw.d....w..wd.....W
W.....wdw...w..w.w......w...w........w.W
W...dwd..w.w...w.w.d.......wwww.w..ww..W
WWWWWWWWWWWWWWWWWWWWWWWWWWWWWWWWWWWWWWWW
[/map]
[/cave]

[cave]
Name=Cave 13
CaveDelay=8
CaveTime=100
DiamondsRequired=10
DiamondValue=30
Colors=Black Black Purple Orange White

[map]
WWWWWWWWWWWWWWWWWWWWWWWWWWWWWWWWWWWWWWWW
W........................X.............W
W.WWWWWWWWWWWW.WWWWWWWWWWW.WWWWWWWWWWW.W
W.W..............W................W..W.W
W.W.WWWWWWWWWWWWWW.WWWWWWWWWWWWWWWWW.W.W
WWW.W..............................W.W.W
W.W.W.WWWWWWWWWWWWWWWWWWWWWWWWWWWW.W.W.W
W.W.WWW..........................W.W.W.W
W.W.W.W.WWWWWWWWWWWWWWWWWWWWWW.W.W.W...W
W.W...W.Wqq                    W.W.W.W.W
W.W.W.W.Wq                     W.W.W.W.W
W...W.W.Wq                     WWW.W.W.W
W.W.W.W.Wq   dddddddddd        W...W.W.W
W.W.W.W.WWWWWWWWWWWWWWWWWWWWWWWW.WWW.W.W
W.W.W.W..........................W.W.W.W
W.W.W.WWWWWWWWWWWWWWWWWWWWWWWWWWWW.W.W.W
W.W.W..............................W.W.W
W.W.WWWWWWWWWWWWWWWWWWWW.WWWWWWWWWWW.W.W
W.W..................W...............W.W
W.WWWW.WWWWWWWWWWWWWWWWWWWWWWWWWWWWWWW.W
W..W................P...........W......W
WWWWWWWWWWWWWWWWWWWWWWWWWWWWWWWWWWWWWWWW
[/map]
[/cave]

[cave]
Name=Cave 14
CaveDelay=8
CaveTime=255
DiamondsRequired=99
DiamondValue=3 4
AmoebaTime=240
Colors=Black Black Brown Gray3 White

[map]
WWWWWWWWWWWWWWWWWWWWWWWWWWWWWWWWWWWWWWWW
WccccccccccccccccccccccccccccccccccccccW
WcWWWWWWWWWWWWWWWWWWWWWWWWWWWWWWWWWWWWcW
WcW                                  WcW
WcW WWWWWWWWWWWWWWWWWWWWWWWWWWWWWWWW WcW
WcW WP......a                      W WcW
WcW W.......a                      W WcW
WcX W.......a                      W WcW
Wc rW.......a                      W WcW
WcW.........a                      W WcW
WcWrr.......a                      W WcW
WcWaaaaaaaaaa                      W WcW
WcW                                W WcW
WcW                                W WcW
WcW                                W WcW
WcW                                W WcW
WcW                                W WcW
WcW                                W WcW
WcW                                  WcW
WcWWWWWWWWWWWWWWWWWWWWWWWWWWWWWWWWWWWWcW
WccccccccccccccccccccccccccccccccccccccW
WWWWWWWWWWWWWWWWWWWWWWWWWWWWWWWWWWWWWWWW
[/map]
[/cave]

[cave]
Name=Cave 15
Intermission=true
CaveDelay=3
CaveTime=40
DiamondsRequired=20
DiamondValue=10 15
AmoebaTime=20
Colors=Black Black Red LightGreen White

[map]
WWWWWWWWWWWWWWWWWWWW
WcW                W
WccrWWWWWWWWWWWWWW W
WcW.Pa           W W
WcXrra           W W
WcWaaa           W W
WcW              W W
WcW              W W
WcW                W
WcWWWWWWWWWWWWWWWWWW
WccccccccccccccccccW
WWWWWWWWWWWWWWWWWWWW
[/map]
[/cave]

[cave]
Name=Cave 16
CaveDelay=8
CaveTime=150
DiamondsRequired=99
DiamondValue=3 4
AmoebaTime=130
Colors=Black Black Purple LightBlue Cyan

[map]
WWWWWWWWWWWWWWWWWWWWWWWWWWWWWWWWWWWWWWWW
W.....................a..............PaW
W......................................W
W......................................W
W......................................W
W......................................W
W......................................W
W............................ w.. w.. wW
W.......................w .w ccw ccw c W
W................. w.  w cc cc c cc.c .W
W...............w cc cc . w c w c wc   W
W...........w. w cc  w c wc  .cwcc wc cW
W.........w cc  . wc  wcwc  ccwcwc  cc W
W....... wcccwcc c w  c c cc wc c .c wcW
W......wc  w cwccwc  cwc .wcc  cw wc  cW
W.....     .w ccwc c w.c wc c  w. cw.c W
W.....wc wc  wcw   cw  c c c cww   c  cW
W...... ccw c  c ccwc wcccwccw cwc ccw W
W.......w c ccccc .   cw . w c  ccc w wW
W......... w.w w c c c cw c wc c w  .w.W
W..............  w wc cc cc c c.w c ...X
WWWWWWWWWWWWWWWWWWWWWWWWWWWWWWWWWWWWWWWW
[/map]
[/cave]

[cave]
Name=Cave 17
CaveDelay=8
CaveTime=130
DiamondsRequired=99
DiamondValue=2 3
AmoebaTime=100
Colors=Black Black Red Gray2 Green

[map]
WWWWWWWWWWWWWWWWWWWWWWWWWWWWWWWWWWWWWWWW
W           aa aaa aa aaa aa aa aa     W
W                                      W
W                                      W
W                                      W
W                                      W
W                                      W
W   wwww  wwww  ww    ww  wwww  wwww   W
Ww  ccccc cw .  wcccw . . wcw   wc c c W
W   .c  c  .cc    c cc     wc   .c c   W
Wc   cccc ccc . .w cc    c w c  ..c  ..W
Wc cwc w c cwccc  c  c w .   c c wcw. cW
Wcc.   c cc  .. c ....c w cc..     .cccW
Wcc  cc . cc w c wr..rwcc .c c    .    W
W  .c  .cc c  cccwrPXrw  .c  ..  c.c ccW
Wc c  .. cw  .  cwrrrrwc  c cc  c wc w.W
W. c  .c c .c  c.wwwwww .c  ccw.  .c c W
W c cw c c ccc. c  .     ..wcw cc w   cW
W.cc.. c..    .  c   .c   cw      wc   W
W c. .w wwc c  cc    w...w.ccw .w   cw W
W c .  c  cc c..c  cwc    .  cc. w.c ccW
WWWWWWWWWWWWWWWWWWWWWWWWWWWWWWWWWWWWWWWW
[/map]
[/cave]

[cave]
Name=Cave 18
CaveDelay=6
CaveTime=90
DiamondsRequired=50
DiamondValue=3 4
Colors=Black Black Red Yellow White

[map]
WWWWWWWWWWWWWWWWWWWWWWWWWWWWWWWWWWWWWWWW
XddddddddddddddddddddddddddddddddddddddW
WddddddddddddddddddddddddddddddddddddddW
WddddddddddddddddddddddddddddddddddddddW
WddddddddddddddddddddddddddddddddddddddW
WddddddddddddddddddddddddddddddddddddddW
WddddddddddddddddddddddddddddddddddddddW
WqqqqqqqqqqqqqqqqqqqqqqqqqqqqqqqqqqdwddW
WqqqqqqqqqqqqqqqqqqqqqqqqqqqqqqqqqqddddW
WqqqqqqqqqqqqqqqqqqqqqqqqqqqqqqqqqqdwddW
WqqqqqqqqqqqqqqqqqqqqqqqqqqqqqqqqqqddddW
WqqqqqqqqqqqqqqqqqqqqqqqqqqqqqqqqqqdwddW
WqqqqqqqqqqqqqqqqqqqqqqqqqqqqqqqqqqddddW
WqqqqqqqqqqqqqqqqqqqqqqqqqqqqqqqqqqdwddW
WqqqqqqqqqqqqqqqqqqqqqqqqqqqqqqqqqqddddW
WqqqqqqqqqqqqqqqqqqqqqqqqqqqqqqqqqqdwddW
WqqqqqqqqqqqqqqqqqqqqqqqqqqqqqqqqqqddddW
WqqqqqqqqqqqqqqqqqqqqqqqqqqqqqqqqqqdwddW
WqqqqqqqqqqqqqqqqqqqqqqqqqqqqqqqqqqddddW
WrrrrrrrrrrrrrrrrrrrrrrrrrrrrrrrrrrwwddW
WP.....................................W
WWWWWWWWWWWWWWWWWWWWWWWWWWWWWWWWWWWWWWWW
[/map]
[/cave]

[cave]
Name=Cave 19
CaveDelay=8
CaveTime=70
DiamondsRequired=99
DiamondValue=3 4
AmoebaTime=20
MagicWallTime=60
Colors=Black Black Orange LightGreen Cyan

[map]
WWWWWWWWWWWWWWWWWWWWWWWWWWWWWWWWWWWWWWWW
XddddddddddddddddddddddddddddddddddddddW
Waaaacccaacccaccacacaacccccc acccaacc.cW
Wcacaa.ccc acc cc.cc cc c  accca.ccc ccW
Wcaaa ccccac aac caccccccccccccaaccccccW
Wcca c.caacac cacccccacac  cacaac aaaccW
Wccaccaa ac c.cccaccca  caacc ccca c c W
Wcc cacc.aaaccc caa ccc ccacaaccaaaaaccW
Wa  a.a cccac.aacccaccaa cacccccc caaacW
W                                      W
W                                      W
WM M M M M M M M M M M M M M M M M M M W
W M   M   M   M   M         M   M   M  W
W   MM  MM  MM  M  MM   M MM  MM  MM   W
W                                      W
WMMMM.MMMMMMMMMMMMMMMMMMMMMMMMMMMMMMMMMW
W                                      W
W                                      W
W                                      W
W                                      W
WP                                     W
WWWWWWWWWWWWWWWWWWWWWWWWWWWWWWWWWWWWWWWW
[/map]
[/cave]

[cave]
Name=Cave 20
Intermission=true
CaveDelay=3
CaveTime=25
DiamondsRequired=28
DiamondValue=10 15
AmoebaTime=5
MagicWallTime=10
Colors=Black Black Brown Gray2 Yellow

[map]
WWWWWWWWWWWWWWWWWWWW
Wcc.ccc cc. c acc. X
W accacaac aacc a aW
Wc   .c   c.  c. ccW
Wa    a   a   a  a W
W   M   M   M   M cW
WMMM MMM MMM MMM MMW
W               M  W
W MMM MMM MMM MMM  W
W                  W
W. . . . . . . .  PW
WWWWWWWWWWWWWWWWWWWW
[/map]
[/cave]

[/game]

[/BDCFF]