; Converted using Tim Stridmann's X2BDCFF converter.
; Last modified: 14 June 2006

[BDCFF]
[game]
Name=Arno Dash 13
Author=Arno Weber
Date=October 2004
WWW=http://www.boulder-dash.nl/
Charset=Original
Fontset=Original
Levels=1
Caves=20

[cave]
Name=Cave 1
CaveDelay=8
CaveTime=38
DiamondsRequired=22
DiamondValue=23 0
AmoebaTime=999
MagicWallTime=35
Colors=Black Black LightRed Red Green

[map]
WWWWWWWWWWWWWWWWWWWWWWWWWWWWWWWWWWWWWWWW
X..r.....d...WawawawawawaW...r...r.....W
W.r.. .r.....WcrcrcrcrcrcW .... ....d..W
W............WrwrwrwrwrwrW..... .....r.W
W..r.rr..r...WwcwcwcwcwcwW...d...r.....W
W..r.rr..... .W r r r r W........r. . .W
W .r..r..d.r..WrwrwrwrwrW...r...r......W
W........d... WwcwcwcwcwW...r......rr..W
Wd.............W r r r W..d...r.. .rrr.W
W....r. ....r..WrwrwrwrW...r.........r.W
W...... ..rr...WwcwcwcwW .....dd....d..W
W..r.d....... ..W r r Wr.........r.....W
W...............WrwrwrWr.. .rr.........W
W.. ...r.d...rr.WwcwcwW.....r.r....r...W
W...r..rd.....r..W r W...r...r... .rr..W
W.r...r.....d....WrwrW..............r..W
W.r.....d.........W W..r.d......r......W
W.... .....r.. ...WMW......r.......d...W
W...... .......r .W W.........d...dd.r.W
W.r .d..rr. .......P....... ..r.r......W
W....r..rr...r.d..WMW..... ......r..  .W
WWWWWWWWWWWWWWWWWWWWWWWWWWWWWWWWWWWWWWWW
[/map]
[/cave]

[cave]
Name=Cave 2
CaveDelay=8
CaveTime=120
DiamondsRequired=60
DiamondValue=8 10
Colors=Black Black LightRed Gray3 White

[map]
WWWWWWWWWWWWWWWWWWWWWWWWWWWWWWWWWWWWWWWW
W.w..w..W..dw....dw..wwwWd.wd...Wwwqw.XW
W.....wdW.....wd.d....d.W..w..w.Www.w..W
Ww......W........w.d...dW.....d.Www.w..W
W...Ww..WdwwWWWWWWWWWdw.W.dwWd..Www.wwwW
Wd.dW...W...WdwwW.d.Wd..Wd..Www.WddddddW
Wd..W...W.dwW..wW...W.w.W...W.w.W......W
W.d.W..dW...W..dW..wW...W..dW...W.wd...W
W...W...W.d.W..wW.dwW.w.WwwdW.dwW......W
Wwd.Wd..W..wWWWWWWWWW...Ww..W...W......W
W...W.d.Ww..W...Www.W..wW...W...W.w.d..W
W...W...W...WwddW...Wd..W...W...W..d...W
W...W...WdwwW...W.d.W.w.W.ddW.d.W..w..dW
Ww..Ww..W...W.w.W...W..wW...W..dW.wd..dW
Wd..W..dW...W..dW...W...W.w.W...Ww.dd..W
W...W.d.Wd.wWWWWWWWWW...Wd.wW...Ww.w...W
Ww..W..dW...W...W.w.W.wdWd.wW..dW..wwdwW
Wwd.W...W.w.W...W...W...Ww..W...W.....dW
W.ddW.wd....W..dWd.wW..w....W..d.wdw...W
W...Wd......W...W...W......dWd.........W
WP.PW.d...dwW.w.Wd.wW.....d.W..w...d...W
WWWWWWWWWWWWWWWWWWWWWWWWWWWWWWWWWWWWWWWW
[/map]
[/cave]

[cave]
Name=Cave 3
CaveDelay=8
CaveTime=170
DiamondsRequired=40
DiamondValue=12 15
Colors=Black Black Gray2 Green White

[map]
WWWWWWWWWWWWWWWWWWWWWWWWWWWWWWWWWWWWWWWW
Wrd .  drr...wq... qq d..r.r....d. ... W
W.rw.qr..w...r..qd dd.  w q..d...ww....W
Wd.w.r d.w..... ... d..w.........dwddq.W
W .wwwwwww...www... ..w.d ..wr qd.w. q.W
W. .. . .wd..w ...d..w...r rw.. ..w ..rW
Wr...dr..wd. w. dd..w.q . ..wwwwwwwwww.W
Wwwr...q.wq..w...rrw..r....... ..dw.. .W
W..  r...wr..wr.. w..d.www .d...drw..P.W
W.....www.....wr...... w....dw.. .dq...W
Wd...w.q.w.  drw.d..d..wd....w. ...d...W
W..rw ....wd....w..wd .wd....w..wwwwwwdW
W..d....  ..w..  ..w....d.d.rw .wr.rr..W
W.r.. .... .wr..d..w..qr.r...w.....d.. W
W.w. r.rqwwwwwwwww.w...r.w...w...rd...wW
W..w.d..... w.... .w..q..wwwww.wd. qrw.W
W...w.d...r.w d.qr.r.. . ......w... w..W
Www..wd. r..w.......qr ..d.w.r.w..dw.  W
W. ..qw...rww ..www....wwwww....d..dr rW
X . ...w....w.r..... ..d..rdd... . q. .W
Wq..d. .r...w r.d .. d.dr.d..... .dr..qW
WWWWWWWWWWWWWWWWWWWWWWWWWWWWWWWWWWWWWWWW
[/map]
[/cave]

[cave]
Name=Cave 4
CaveDelay=8
CaveTime=120
DiamondsRequired=99
DiamondValue=4 8
AmoebaTime=230
Colors=Black Black Orange Blue Red

[map]
WWWWWWWWWWWWWWWWWWWWWWWWWWWWWWWWWWWWWWWW
X .ccqcc.          P         WW WW    .W
W  ..c..      W        .      aWa    .cW
W   .c.      aWa      .c.      W    ..cW
W    .      WW WW    ..c..         .ccqW
WW           aWa    .ccqcc.         ..cW
WWa     .     W      ..c..           .cW
W WW   .c.            .c.             .W
WWa   ..c..            .               W
WW   .ccqcc.       W            .      W
W     ..c..       aWa          .c.     W
W      .c.       WW WW        ..c..    W
W       .         aWa        .ccqcc.   W
W    W             W          ..c..    W
W   aWa                        .c.     W
W  WW WW                        .   W  W
W   aWa                            aWa W
W    W       .         W          WW WWW
W           .c.       aWa          aWa W
W          ..c..     WW WW          W  W
W         .ccqcc.     aWa              W
WWWWWWWWWWWWWWWWWWWWWWWWWWWWWWWWWWWWWWWW
[/map]
[/cave]

[cave]
Name=Cave 5
Intermission=true
CaveDelay=3
CaveTime=10
DiamondsRequired=1
DiamondValue=99 0
Colors=Black Black Orange Red White

[map]
WWWWWWWWWWWW
W         qW
W  d     qWW
W  P    qWWW
W      qWWWW
W     qWWWWW
W    qWWWWWW
W   qWWWWWWW
W  qWWWWWWWW
W  WWWWWWWWW
X WWWWWWWWWW
WWWWWWWWWWWW
[/map]
[/cave]

[cave]
Name=Cave 6
CaveDelay=8
CaveTime=150
DiamondsRequired=50
DiamondValue=8 10
SlimePermeability=0.250
Colors=Black Black Brown LightBlue Yellow

[map]
WWWWWWWWWWWWWWWWWWWWWWWWWWWWWWWWWWWWWWWW
WddrddrrrddrrddrrdrdrddrrddrrdrrrdddrddW
WrddrrdrrrrddrrdrrrdrddrrdrsrddrdddrdddW
Wrrrsrrdrrdrdddddddrdsrddrs sddddddrrdrW
Wdrs srdddrrrddddddrs sdrs   sdrdrdrdrrW
Wds   sddrdrdrrrddrs   ss     srrdsdrddW
Ws     srrddrssddds            srs srrdW
X  c    srdrs  sds              s   srdW
W   c    srs    s            c       srW
W         s           q               sW
W w   w   c   c    w   w               W
W  w w              w w    w   w  q    W
W   w   w   w        w      w w    c   W
W        w w             c   w         W
W    c    w                            W
W  q          w   w                    W
W   w   w      w w             w   w   W
W    w w  q     w      w   w    w w  c W
W     w                 w w  q   w     W
W          c       q     w          c  W
W q    q          qPq                  W
WWWWWWWWWWWWWWWWWWWWWWWWWWWWWWWWWWWWWWWW
[/map]
[/cave]

[cave]
Name=Cave 7
CaveDelay=8
CaveTime=169
DiamondsRequired=89
DiamondValue=6 0
Colors=Black Black Orange LightRed Yellow

[map]
WWWWWWWWWWWWWWWWWWWWWWWWWWWWWWWWWWWWWWWW
WrWW  q   q   q   q   q   .            W
W... dW  dW  dW  dW  dW   W            W
W.WW .W  .W  .W  .W  .W   W         q  W
W..W dW  dW  dW  dW  dW   W  d.d..d.d  W
WW.W .W  .W  .W  .W  .W   W  WWWWWWWW  W
WW.W dW  dW  dW  dW  dW   W            W
Wr.W .W  .W  .W  .W  .W   W         q  W
W..W                      W  d.d..d.d  W
W.WWWWWWWWWWWWWWWWWWWWWWWWW  WWWWWWWW  W
Wd.d.d       d.d.d.d.d.d.dW            W
WWWWWW   q   WWWWWWWWWWWWWW         q  W
Wd.d.d.d.d         d.d.d.dW  d.d..d.d  W
WWWWWWWWWW        qWWWWWWWW  WWWWWWWW  W
Wd.d.d.d       d.d.d.d.d.dW            W
WWWWWWWW   q   WWWWWWWWWWWW         q  W
Wd.d.d.d.d.d     d.d.d.d.dW  d.d..d.d  W
WWWWWWWWWWWW     WWWWWWWWWW  WWWWWWWW  W
Wd.d.d.d.d.d       d.d.d.dW            W
WWWWWWWWWWWW       WWWWWWWW            W
Wd.d.d.d.dq         qd.d.dX           PW
WWWWWWWWWWWWWWWWWWWWWWWWWWWWWWWWWWWWWWWW
[/map]
[/cave]

[cave]
Name=Cave 8
CaveDelay=8
CaveTime=220
DiamondsRequired=60
DiamondValue=8 12
MagicWallTime=30
Colors=Black Black Green Yellow White

[map]
WWWWWWWWWWWWWWWWWWWWWWWWWWWWWWWWWWWWWWWW
X....rrw..rrrrrrrrr......wrdddqWrWrWdWdW
Wdrr.r..w..rrrcccr..wr...rwdcrdWrWrWrWdW
W.r...r.dw..rrqqr..w..r.r..wdrdWrWdWdWrW
W.r.d.r.r.w..rrr..w....r....wdrWdWrWrWdW
WMrr.d.....w..r..w...........w.........W
W M..r..rr..w...w    ....... qw........W
W  M.r.d.r.drw.wd WW ......  ..wq      W
W   Md..r..d..wd. WW .w.w.  ...dw.....wW
W    Mr...r...dwd q  wdrdw ...dw w...w W
W     M...r..r..wd.dwddrrdw..dw   w.w  W
W      M.rd..rrw wdwdrrdrdrwdwc        W
W       M..dr.w   wddrrddrddw          W
W        M...w     wdrdrrdrw           W
W         M.w       wddrddw            W
W                    wdrdw             W
W                     w.w              W
W                                      W
W                                     cW
W                                    qqW
W      q       q                    cqPW
WWWWWWWWWWWWWWWWWWWWWWWWWWWWWWWWWWWWWWWW
[/map]
[/cave]

[cave]
Name=Cave 9
CaveDelay=8
CaveTime=160
DiamondsRequired=65
DiamondValue=8 10
MagicWallTime=55
Colors=Black Black Red Purple Yellow

[map]
WWWWWWWWWWWWWWWWWWWWWWWWWWWWWWWWWWWWWWWW
X       rW . . . ..r...................W
W       .W.WWWWWWW.w.W.W.W.W.W.WrW.W.W.W
W       rW Wrdrd.W W.WcWcWcWcWcWcWcWcWcW
W       .W.Wdrd.  r..WcWcWcWcWcWcWcWcWcW
W       rW Wrd.  w.WWWcWcWcWcWcWcWcWcWcW
W       .W.Wd.  w....WcWcWcWcWcWcWcWcWcW
W        W W.  w.rwW.WcWcWcWcWcWcWcWcWcW
W        W.W  w.rwwW.WcWcWcWcWcWcWcWcWcW
W        W W w.rwwwW.WcWcWcWcWcWcWcWcWcW
W        W.W  .rWWWW.WcWcWcWcWcWcWcWcWcW
W        W WM  .rdrd.WcWcWcWcWcWcWcWcWcW
W        W.W M  .rdr.WcWcWcWcWcWcWcWcWcW
W        W W .M  .rd.WcWcWcWcWcWcWcWcWcW
W        W.W ..M  .r.WcWcWcWcWcWcWcWcWcW
W        W W ...M  ..WrWrWrWrWrWrWrWrWrW
W        W.W ....M  .W.................W
W        W W .....M  W.................W
W        W.W ......M W.................W
W        W W ....... W.................W
W         .W ....... W................PW
WWWWWWWWWWWWWWWWWWWWWWWWWWWWWWWWWWWWWWWW
[/map]
[/cave]

[cave]
Name=Cave 10
Intermission=true
CaveDelay=3
CaveTime=30
DiamondsRequired=6
DiamondValue=80 0
Colors=Black Black Orange Gray2 Blue

[map]
WWWWWWWWWWWWWWWWWWWW
WwrwwwrwwwrwwwrwwwrW
XP.W...W...W...W...W
W. W . w . W . W .cW
W. W . W . W .qW . W
W. W . W .qW . W . W
W. W .qW . w . W . W
W.qW . W . W . W . W
W. w . W . W . W . W
W. W . W . W . W . W
W. W . W . W . w . W
WWWWWWWWWWWWWWWWWWWW
[/map]
[/cave]

[cave]
Name=Cave 11
CaveDelay=8
CaveTime=255
DiamondsRequired=29
DiamondValue=20 0
Colors=Black Black LightBlue LightGreen White

[map]
WWWWWWWWWWWWWWWWWWWWWWWWWWWWWWWWWWWWWWWW
W                                   rr.X
W w.d..r.w.rr.rr.rwr.....rrw.r....r.wrrW
W w.d..r.w..r..r..w.r...r.dwrrr..d.rw.qW
W w..rr.rwrrr.r..rw.rr..q.dwrr...r..w.rW
W w.rrrdrw.rr.rr.rwrr...r..wd.....r.w.rW
W w.r..r.w.r.rrrd.wr..r....wrr.r.r.rw.qW
W wwwwwwwwwwwwwwwwwwwwwwwwwwwwwwwwwww.rW
W wdrr...w.r.r..rdw.rr..rrdw.r..r..dw.rW
W w.qr.r.w.rrr.rr.wddr...q.w...rrq.dw.qW
W w.....rw.dr...rrwr..r..rrw..r...q.w.rW
W wrrr..rwr.r.....w.rrr...rwdr....r.w.rW
W w..r.r.w.r..r...w.r.rr...w.r...rrrw.qW
W wwwww.wwwwwwwww.ww.wwwwwwwwww.wwwww.rW
W                                   w.rW
Www.wwwwwwwww.wwwwwwwwww.wwwwwwwwww.w.qW
W...rrrdrw.....rrrwrrrr....wddr....rw.rW
Wr.rrrrr.w..rq..rrwr.rrr.r.wd.r..r.dw.rW
W....rrr.wr..r.rrrw..rr.rrdwr...d..rw.qW
Wrd.rrr.rw.......dwr.r.r.r.w.rq.r..rw.rW
W......r.w..r...rrwrdd.....w.r...dr.P..W
WWWWWWWWWWWWWWWWWWWWWWWWWWWWWWWWWWWWWWWW
[/map]
[/cave]

[cave]
Name=Cave 12
CaveDelay=8
CaveTime=120
DiamondsRequired=99
DiamondValue=2 3
SlimePermeability=0.500
AmoebaTime=40
Colors=Black Black Green Brown Yellow

[map]
WWWWWWWWWWWWWWWWWWWWWWWWWWWWWWWWWWWWWWWW
W......................................W
W......................................W
WaaaaaaaaaaaaaaaaaaaaaaaaaaaaaaaaaaaaaaW
WssssssssssssssssssssssssssssssssssssssW
W    c             c            c      W
W        c   c          c              W
W                        c   c     c  cW
W c            c     c                cW
W  W   W   W   W   W   W   W   W   W   W
W    c                                 W
WW   W   W   W   W   W   W   W   W c W W
W      c           P               c   W
W       c c   c           c       c    W
Wcc W   W   W  cW   W   W   W   W   W  W
W c            c      c                W
W W   W   W   W   W   W c W   W   W   WW
W                                      X
W          c           c     c     c   W
W    c    c       c               c    W
W        c     c                 c     W
WWWWWWWWWWWWWWWWWWWWWWWWWWWWWWWWWWWWWWWW
[/map]
[/cave]

[cave]
Name=Cave 13
CaveDelay=8
CaveTime=150
DiamondsRequired=50
DiamondValue=9 10
Colors=Black Black Green Purple Yellow

[map]
WWWWWWWWWWWWWWWWWWWWWWWWWWWWWWWWWWWWWWWW
WrrrrrrrrrrrWrrrrrrrrrrrrWrrrrrrrrrrrrrW
W...........W............W.............W
W...........W............W.............W
W...........W..P.... ....W........ ....W
W.... ......W......   ...c.......   ...W
W... c ..... .....     .  c.....  c  ..W
W..   c ... c ... c  c      ...       .W
W.   c   .    c.             .         W
W          c        c   c       c      W
Ww   w   w   w   w c w   w   w   w   w W
WcqcqcqcqcqcqcqcqcqcqcqcqcqcqcqcqcqcqcqW
W  w   w   w   w   w   w   w   w   w   W
W                                      W
W                                      W
WwwwwwwwwwwwwwwwwwwwwwwwwwwwwwwwwwwwwwwW
W..r...r...r...r...r...r...r...r...r...W
W......................................W
W..q...q...q...q...q...q...q...q...q...W
WWW WWW WWW WWW WWW WWW WWW WWW WWW WWWW
W..w...w...w...w...w...w...w...w...w...X
WWWWWWWWWWWWWWWWWWWWWWWWWWWWWWWWWWWWWWWW
[/map]
[/cave]

[cave]
Name=Cave 14
CaveDelay=8
CaveTime=200
DiamondsRequired=80
DiamondValue=7 10
SlimePermeability=0.250
MagicWallTime=4
Colors=Black Black Green Cyan White

[map]
WWWWWWWWWWWWWWWWWWWWWWWWWWWWWWWWWWWWWWWW
W.rqwddXW  r..d............rrrrrrrrrrrrW
W.W wddW  w..drWWWWWWWWWWWWssrssssssssrW
W.W wdW  w..dr..rWrWdrdrdrW    r r r   W
W.W wW  w..dr.c rW..dddrrdWsssssss ssssW
W.W W  w..dr.   .WcWrdrddrW  r     r   W
W.WW  w..dr.c   .W W.dddrrWsss ssssss sW
W.W  w..dr.     .W.WdwddddWr  r   r    W
W.  w..dr.c     .WcWddwrddWs sss ssssssW
W  w..dr.       .W WrddwdrW    r    r rW
W w..dr.c       .W.WddddwdWssssssss sssW
WM..dr.         rWqWdrdrdwW  r   r   r W
Wq.dr.c         .w WddddddWs sssssssss W
W WWWWWWWWWWWWWWWWWWddrddrW r r    r   W
W w.xdx..ddx..xd..xWdrrdr.Wssss ss ssssW
W w...xd.x...d..xd.Wddrrw W  r  r   r  W
W wd......x.xx..x.xWdrdw  W ssssssssss W
W w.xx..x....dx...dWddw   W            W
W w....xxd.x...dxx.Wrw    W            W
W w.xd......x....d.Ww     W            W
W w..dx.xdx..dx..W..      W      P     W
WWWWWWWWWWWWWWWWWWWWWWWWWWWWWWWWWWWWWWWW
[/map]
[/cave]

[cave]
Name=Cave 15
Intermission=true
CaveDelay=3
CaveTime=8
DiamondsRequired=1
DiamondValue=99 0
SlimePermeability=0.250
MagicWallTime=999
Colors=Black Black Blue Brown Yellow

[map]
WWWWWWWWWWWWWWWWWWWW
WrrrrrrrrrrrrrrrrrrW
WrrrrrrrrrrrrrrrrrrW
WrrrrrrrrrrrrrrrrrrW
WsrrrsrrrsrrrsrrrsrW
W srs srs srs srs sW
W  s   s   s   s   W
W                  W
Ww                wW
XP                dW
WMMMMMMMMMMMMMMMMMMW
WWWWWWWWWWWWWWWWWWWW
[/map]
[/cave]

[cave]
Name=Cave 16
CaveDelay=8
CaveTime=185
DiamondsRequired=99
DiamondValue=4 5
AmoebaTime=160
MagicWallTime=40
Colors=Black Black LightRed Orange Green

[map]
WWWWWWWWWWWWWWWWWWWWWWWWWWWWWWWWWWWWWWWW
W  qr  cr         aaaa          .  cr PW
W WWW WWW.WWWW.wwwwwwwwww.WWWW.WW WWW.WW
W WWW W..  q  ............  q  .W Wqr.WW
WwwWw w.. ... .wwww.xx.ww. ... .w W WWWW
WddWw w.. .d. .w........w. .d. .w W WddW
WddWwww.. .d. .w.xxxx.www. .d. .wwW WddW
WWWWW.W.. ... .w........w. ... ...W w..W
W..cr.W..     .www.xxxx.w.     .r.w w..W
W.W WWW........w........w.......cWwwwW.W
W.W wdd........ww.xxxx.ww.......r..ddW.W
W.W wdd......rrw........wrr........ddW.W
W.Www........qdwddddddddwdq..........W.W
W.rrrrrrrr...rdwwwwXWwwwwdr...rrrrrrrr.W
W.............d....dd....d.............W
WMMMMMMMMM....................MMMMMMMMMW
W                                      W
W                                      W
W                                      W
WccccccccccccccccccccccccccccccccccccccW
WccccccccccccccccccccccccccccccccccccccW
WWWWWWWWWWWWWWWWWWWWWWWWWWWWWWWWWWWWWWWW
[/map]
[/cave]

[cave]
Name=Cave 17
CaveDelay=9
CaveTime=180
DiamondsRequired=16
DiamondValue=32 40
MagicWallTime=150
Colors=Black Black Brown LightRed Yellow

[map]
WWWWWWWWWWWWWWWWWWWWWWWWWWWWWWWWWWWWWWWW
W..r.Mr.r..M. ......M.r..r ..Mr........W
WM.r........M ...r.......M ..MMr..r..MMW
W....r.rM.... .r...P...... ....r.......W
W..M......... .r.M....M.r. ............W
W............q.r.......r.rqr.M.........W
W.WWWWWWWWWWWWWWWWWWWWWWWWWWWWWWWWWWWW.W
W..r......r.. .r........r. r.r.r.....r.W
W...M..r.r.r. ...rr...r... ..r.........W
Wr........... ...M........ .M...r.rr.M.W
W.r....M..... ...r.M....M. ...r...r.Mr.W
W.M..r.....M. ..r....r.M.. M..r.....M..W
W........r...q...M...r.Mrrq.rM.........W
W.WWWWWWWWWWWWWWWWWWWWWWWWWWWWWWWWWWWX.W
W...r...r.... ....M..rM... ..M.MM...rr.W
W...Mr....... M.rr...r.... ..r.....r...W
W...........r ....r....r.. .r...rr.r...W
W.......M.... ...r.......M ......r.....W
W..r..r...r.M .......r.r.. .r......M...W
W.....r..r... ...M......rM .....r.....rW
WM...r..r.r.Mq..........MrqM..M.....rM.W
WWWWWWWWWWWWWWWWWWWWWWWWWWWWWWWWWWWWWWWW
[/map]
[/cave]

[cave]
Name=Cave 18
CaveDelay=8
CaveTime=175
DiamondsRequired=80
DiamondValue=6 7
AmoebaTime=240
Colors=Black Black Green Brown Purple

[map]
WWWWWWWWWWWWWWWWWWWWWWWWWWWWWWWWWWWWWWWW
WP.....................................X
W.. . .. ... c..  . . .. c.  .. ..c....W
W. c    .. . . . c  c...  ..c.  . .....W
W.. .c   c... . .c..  c..   . c.c. ....W
W...c. . . ..   c . ...... .  c . .....W
W.c . .c...a. .. ... ..a... .. ....a...W
W.........aaa.........aaa.........aaa..W
W. .. .....a.... .c.. .a.. ..  . ..a...W
W... . .. ...  ....  .......   .  .....W
W.. c   ..c....  .  . .. ccc. c  . ....W
W.    ..  c. . c  .. c ..    .cc  .....W
W... cc  ....c..c  .c .. . .. ..  .....W
W..   . .c.a... ...  ..a.... .. ...a...W
W.........aaa.........aaa.........aaa..W
W... . ....a... . .c ..a... .. .. .a...W
W.... . .. . .  .. ....... c . .c......W
W.  .c .c c..c. c.c.  .. .c    c.c ....W
W.. cc .  ..  c   .  .c..  ..    . ....W
W.c. ..  ..... ..   . .. ..c. ..  .....W
W......................................W
WWWWWWWWWWWWWWWWWWWWWWWWWWWWWWWWWWWWWWWW
[/map]
[/cave]

[cave]
Name=Cave 19
CaveDelay=8
CaveTime=100
DiamondsRequired=99
DiamondValue=5 8
AmoebaTime=140
MagicWallTime=90
Colors=Black Black Yellow Gray1 Green

[map]
WWWWWWWWWWWWWWWWWWWWWWWWWWWWWWWWWWWWWWWW
W M.  M  W  c  a  ca qq    c  .  c.q.  X
WM    .  M  aW   c. M     cW       c  MW
W aq       rc Mr . r  . cc  .M q ac. c W
W a    M  .    a .      .  ..  aaMc.  aW
W M   ca  aM    M M a. qWaW..  .   a rMW
W    c   .    a     M    a. .   .a .   W
W r          .MW . a.qa.           . . W
W   .r a.  .q  . rqWq ca          a   cW
W. W  rM q.a  a a  a c  MM.  cca  rc   W
W  c    c M M M  r  c .   . c   aMr  M W
W c M .  .a    .  c M   c M.    .  M   W
W M c   M         c  M.  caM.  r   q   W
W .    .   c a a aac   c   ca M      M W
W  Mq McM         c    qca        W Mr W
W. M   .    aW    . a  c  a  c a     a W
WaW c. M.   .W M   . c   ar.arMa  M    W
W.c cc    W.c c         rr  .M  c   Wa W
W ca   W  q  M      P    M    .   a   WW
W aac .      cc  q    a   r     c    r.W
W    c  qW   ac    a    a       c      W
WWWWWWWWWWWWWWWWWWWWWWWWWWWWWWWWWWWWWWWW
[/map]
[/cave]

[cave]
Name=Cave 20
Intermission=true
CaveDelay=3
CaveTime=30
DiamondsRequired=20
DiamondValue=25 0
Colors=Black Black Orange Green Purple

[map]
WWWWWWWWWWWWWWWWWWWW
W  .   .         d W
Wd d.      d    d  W
W    .  d  d     . W
W d       P        W
W  .      d.  .  d W
W   d.        .. d W
H     d     ..     W
W         . d d  d W
W .d . .    d d    W
W       d .        W
WWWWWWWWWWWWWWWWWWWW
[/map]
[/cave]
[/game]
[/BDCFF]
