; Converted using Tim Stridmann's X2BDCFF converter.
; Last modified: 14 January 2007

[BDCFF]
[game]
Name=Exploding Dash 2
Author=Arno Weber
Date=October 2006
WWW=http://www.boulder-dash.nl/
Charset=Original
Fontset=Original
Levels=1
Caves=20

[cave]
Name=Cave 1
CaveDelay=8
CaveTime=200
DiamondsRequired=99
DiamondValue=2 3
MagicWallTime=42
Colors=Black Black LightBlue Gray2 Yellow

[map]
WWWWWWWWWWWWWWWWWWWWWWWWWWWWWWWWWWWWWWWW
W...r..r..rr r....r....rr r.....r.W r PX
W...r..c..wr.q....c....wr.q.....c.W WW W
W...r .r...w.r....r.....w.r.....r.WcW.rW
W.. .c.r... .r..q.r..... .r.....rW.WW.rW
W.. . .r... wrW  wr....  wr... qr. ...rW
W..M...r...M.r. w.r...  w.r..  wr.q...rW
W..c...r...c.r. ..r... w..rW  w..WWW..rW
W.. ...rWq. ..WW..r...M...r. w....r...rW
W......r. ........r... ...r. .....c..WrW
Wr.q...r. ...r....rWq.c....WW.....r.c.rW
WrW W..rWW...c....r. ....r........r. WrW
Wr.W..r......r. ..r. ....c........r. .rW
Ww ...c......r.  ..WW....r.c......r..WrW
W.  ..r.c....r.w  ...r...r. .c....r. .rW
W.w ..r. .c..r..w  ..c. .r. . .c..r. WrW
W..  .r. . ..r...w  .r. .r... . ..r. .rW
W..w .r... ..r....w .r. .r..... ..r. WrW
W...M.r.....Wr.....M.r.M.r.......Wr.M.rW
W... .r....q.r..... .r. .r......q.r.q.rW
W...q.r.... .r.....q.r.q.r...... .r. .rW
WWWWWWWWWWWWWWWWWWWWWWWWWWWWWWWWWWWWWWWW
[/map]
[/cave]

[cave]
Name=Cave 2
CaveDelay=8
CaveTime=255
DiamondsRequired=1
DiamondValue=99 0
AmoebaTime=20
Colors=Black Black Blue Red Yellow

[map]
WWWWWWWWWWWWWWWWWWWWWWWWWWWWWWWWWWWWWWWW
WqqqqqqqqqqWWWrWWWWWWWWWWWWWWWWWWWWWWWWW
WqqqqqqqqqqWWqr.......................PW
WqqqqqqqqqqW  WWWWWWWWWWWWWWWWWWWWWWWW.W
Wqqqqqqqqqqw w         a             W.W
Wqqqqqqqqqqw w         a             W.W
WqqqqqqqqqqWWWWWWWWWWWWWWWWWWWWWWWW  W.W
WqqqqqqqqqqW                         W.W
WqqqqqqqqqqW                         W.W
WqqqqqqqqqqW                         W.W
WqqqqqqqqqqW   WWWWWWWWWWWWWWWWWWWWWWW.W
WqqqqqqqqqqW   W.......................W
WqqqqqqqqqqW   WWWWWWWWWWWWWWWWWWWWWWW.W
WqqqqqqqqqqW                         W.W
WqqqqqqqqqqW                         W.W
WqqqqqqqqqqW                         W.W
WqqqqqqqqqqWWWWWWWWWWWWWWWWWWWWWWWW  W.W
WqqqqqqqqqqWW..                      W.W
WqqqqqqqqqqWWc.                      W.W
WqqqqqqqqqqW WWWWWWWWWWWWWWWWWWWWWWWWW.W
WqqqqqqqqqqX ..........................W
WWWWWWWWWWWWWWWWWWWWWWWWWWWWWWWWWWWWWWWW
[/map]
[/cave]

[cave]
Name=Cave 3
CaveDelay=8
CaveTime=250
DiamondsRequired=85
DiamondValue=6 8
MagicWallTime=40
Colors=Black Black Purple Yellow White

[map]
WWWWWWWWWWWWWWWWWWWWWWWWWWWWWWWWWWWWWWWW
W.rrrddrr.r.rr.d.r...r.d...........r...W
Wcddrqrddrdddqrr.......................W
Wrd.rrc.d.r.r....................wwMww W
Wdcr..rd.r.....................r.w  cw W
W.rqrr..r..............r.........wq  w W
W.ddr...........r...........rwwMwwwwww W
Wr.d.r............r.PwwMww...w q w     W
Wd.........r.wwwMw...w   wwwMw  cw wwwrW
W............wc  wMwwwqc w  cwwwww wrrdW
W.......rwwMww q w q wwwww  qw     wdr.W
W.r......wq cwwwww c w   wwwww wwwwwdrrW
W....wwwMw   w   wwwww w       wrr.rqrdW
WwMwww q wwwww w       wwwwwwwww.dd.rd.W
Wwc  w c w     wwwwwwwwwdWdw.d.rcdrddrdW
Xw q wwwww wwwwwrWrWrWrWrWrwr.r.d.r.rcdW
Wwwwww     wdWdWqWqWqWqWqWqw...r.rqrd.dW
W      wwwwwrWrWrWrWrWrWrWrw.r.rdrddrd.W
W wwwwww...wqWqWqWqWqWqWqWqw...dr.ddddrW
W w......w.wrWrWrWrWrWrWrWrw.....r.d.dqW
W  .xxxxxw...w.w.w.w.w.w.w.w........rddW
WWWWWWWWWWWWWWWWWWWWWWWWWWWWWWWWWWWWWWWW
[/map]
[/cave]

[cave]
Name=Cave 4
CaveDelay=8
CaveTime=50
DiamondsRequired=1
DiamondValue=8 10
AmoebaTime=10
MagicWallTime=20
Colors=Black Black Purple LightRed Green

[map]
WWWWWWWWWWWWWWWWWWWWWWWWWWWWWWWWWWWWWWWW
WaaaaaaaaaaaaaaaaaaPaaaaaaaaaaaaaaaaaaaX
WaaaaaaaaaaaaaaaaaaaaaaaaaaaaaaaaaaaaaaW
WaaaaaaaaaaaaaaaaaaaaaaaaaaaaaaaaaaaaaaW
WaaaaaaaaaaaaaaaaaaaaaaaaaaaaaaaaaaaaaaW
WaaaaaaaaaaaaaaaaaaaaaaaaaaaaaaaaaaaaaaW
Waaaa                              aaaaW
W                                      W
W q q q q q q q q q q q q q q q q q q  W
W  c c c c c c c c c c c c c c c c c c W
W q q q q q q q q q q q q q q q q q q  W
W  c c c c c c c c c c c c c c c c c c W
W q q q q q q q q q q q q q q q q q q  W
W  c c c c c c c c c c c c c c c c c c W
W q q q q q q q q q q q q q q q q q q  W
W  c c c c c c c c c c c c c c c c c c W
W q q q q q q q q q q q q q q q q q q  W
W  c c c c c c c c c c c c c c c c c c W
W                                      W
WMMMMMMMMMMMMMMMMMMMMMMMMMMMMMMMMMMMMMMW
WMMMMMMMMMMMMMMMMMMMMMMMMMMMMMMMMMMMMMMW
WWWWWWWWWWWWWWWWWWWWWWWWWWWWWWWWWWWWWWWW
[/map]
[/cave]

[cave]
Name=Cave 5
Intermission=true
CaveDelay=8
CaveTime=40
DiamondsRequired=54
DiamondValue=9 0
Colors=Black Black Purple Brown Yellow

[map]
XXXXXXXXXXXXXXXXXXXXWWWWWWWWWWWWWWWWWWWW
X.P..............c.XW..................W
XP..........P......XW..................W
X......P......P....XW..................W
X..................XW..................W
X.P.....c..........XW..................W
X..................XW..................W
X...P........c....cXW..................W
X..c...............XW..................W
X.........c.....c..XW..................W
X..................XW..................W
XXXXXXXXXXXXXXXXXXXXW..................W
WWWWWWWWWWWWWWWWWWWWW..................W
W......................................W
W......................................W
W......................................W
W......................................W
W......................................W
W......................................W
W......................................W
W......................................W
WWWWWWWWWWWWWWWWWWWWWWWWWWWWWWWWWWWWWWWW
[/map]
[/cave]

[cave]
Name=Cave 6
CaveDelay=8
CaveTime=80
DiamondsRequired=8
DiamondValue=50 0
AmoebaTime=20
MagicWallTime=30
Colors=Black Black Purple LightRed Green

[map]
WWWWWWWWWWWWWWWWWWWWWWWWWWWWWWWWWWWWWWWW
W..  .a. . .. aaddddddddaa   . q .a....X
W .a  q...q . aaWWWWWWWWaaa aq...  a  .W
W . ..  .q . q a. ...a..aq q . .q a qq.W
W a aaaaqqa a   qa  .  .  q.  . .   .. W
W. q .  .    ...  a.qa.    .q. .. .  . W
W.aq.. q.aqq q ..  . . . a . . q.a  a. W
W a.aq.  q.a   q..q ...    a qq. . qaq W
W q.. a   a. aq . .q.  .  .. . .. q . .W
W.   qa. q a.    qa... .   q.qa  q .q  W
W.aa   .  .a q  a   ..q.a.  a. aqq... .W
W  ... qa a a...q.q. qq  aa. .   q. .q W
W.aqq   .qa  .a..  .a   aa.aaa.. q. .q.W
W. a ...q. . q  aa   . qq.. .a.a  . ..qW
Wa..a.. ...    aaa. aq.a..      a  .   W
W .     .aq .a.q.. a. ...aa qq.....  ..W
W   . q  .q..  .qaq.qq ...a.. .a. q   .W
W   ..     q.   .a   qa. q ...a   ...q W
Wa ..        .q  . ...  . .  .. .   .  W
W  a ......qa.a  q  P a      .. .... q W
WMMMMMMMMMMMMMMMMMMMMMMMMMMMMMMMMMMMMMMW
WWWWWWWWWWWWWWWWWWWWWWWWWWWWWWWWWWWWWWWW
[/map]
[/cave]

[cave]
Name=Cave 7
CaveDelay=8
CaveTime=100
DiamondsRequired=99
DiamondValue=3 5
Colors=Black Black Orange Blue Cyan

[map]
WWWWWWWWWWWWWWWWWWWWWWWWWWWWWWWWWWWWWWWW
WP                 r .                 X
WWWWWWWWWWWWWWWWWWWW WWWWWWWWWWWWWWWWWWW
WWWWWWWWWWWWWWWWWW .c. WWWWWWWWWWWWWWWWW
WWWWWWWWWWWWWWWW . .r. . WWWWWWWWWWWWWWW
WWWWWWWWWWWWWW . .cWqWc. . WWWWWWWWWWWWW
WWWWWWWWWWWW . .cWWWrWWWc. . WWWWWWWWWWW
WWWWWWWWWW . .cWWWWWrWWWWWc. . WWWWWWWWW
WWWWWWWW . .cWWW WWrrrWW WWWc. . WWWWWWW
WWWWWW . .cWWW  r .crc. r  WWWc. . WWWWW
WWWW . .cWWWWr  . .rrr. .  rWWWWc. . WWW
WW . .cWWWWWWc.W.cWrrrWc.W.cWWWWWWc. . W
WW .cWWWWWW .r. WWWrrrWWW .r. WWWWWWc. W
WWcWWWWWW . .r. . WrrrW . .r. . WWWWWWcW
WW..WWWW. .cWrWc. .rrr. .cWrWc. .WWWW..W
WW. . WWWcWWWr.wWq.rcr.qWw.rWWWcWWW . .W
WWWc. . WWWWWr. WWWWrWWWW .rWWWWW . .cWW
WWWWWc. . WWWr.c.r.WrW.r.c.rWWW . .cWWWW
WWWWWWWc. . Wr.wWq.rrr.qWw.rW . .cWWWWWW
WWWWWWWWWc. .r. Wr.rrr.rW .r. .cWWWWWWWW
WWWWWWWWWWWq.r.q.q.rrr.q.q.r.qWWWWWWWWWW
WWWWWWWWWWWWWWWWWWWWWWWWWWWWWWWWWWWWWWWW
[/map]
[/cave]

[cave]
Name=Cave 8
CaveDelay=8
CaveTime=255
DiamondsRequired=99
DiamondValue=5 6
AmoebaTime=255
MagicWallTime=100
Colors=Black Black Gray3 Purple Yellow

[map]
WWWWWWWWWWWWWWWWWWWWWWWWWWWWWWWWWWWWWWWW
WP...a.........q...........c.........c.W
W.......c..............a..q.......a....W
W.............a..c...a.........cc......W
W.....q..........c..............c...c..W
W.c.......q.c.....c...................qW
W.......qc..............c.......c......W
W......................................W
W                                      W
W  wM      X                X      Mw  W
W  w M    MXMM            MMXM    M w  W
W  w  M  M X  M    MM    M  X M  M  w  W
W  w   MM      M  M  M  M      MM   w  W
W  w            MM    MM            w  W
W XXXX     w                w     XXXX W
W  w     wwww ccXccwwccXcc wwww     w  W
W  wcqqqcc wq qcXcq  qcXcq qwcccqqqcw  W
W  wwcccwcc  ccwXwc  cwXwcc  ccwcccww  W
W  w wcw wccccw X wccw X wccccw wcw w  W
W  w  w   wwww     ww     wwww   w  w  W
W                                      W
WWWWWWWWWWWWWWWWWWWWWWWWWWWWWWWWWWWWWWWW
[/map]
[/cave]

[cave]
Name=Cave 9
CaveDelay=8
CaveTime=120
DiamondsRequired=99
DiamondValue=4 6
Colors=Black Black Cyan LightGreen White

[map]
WWWWWWWWWWWWWWWWWWWWWWWWWWWWWWWWWWWWWWWW
W          rrrrrrrrrrrrrrrrrrrrrrrrrrrrX
W         rqqqqqqqqqqqqqqqqqqqqqqqqqqqqW
W        rrrrrrrrrrrrrrrrrrrrrrrrrrrrrrW
W       rccccccccccccccccccccccccccccccW
W      ..rrrrrrrrrrrrrrrrrrrrrrrrrrrrrrW
W     rr...rrqqqqqqqqqqqqqqqqqqqqqqqqqqW
W    rrrrr...rrrrrrrrrrrrrrrrrrrrrrrrrrW
W   rcccccrr...rrccccccccccccccccccccccW
W  rrrrrrrrrrr...rrrrrrrrrrrrrrrrrrrrrrW
W rqqqqqqqqqqqrr...rrqqqqqqqqqqqqqqqqqqW
W.rrrrrrrrrrrrrrrr...rrrrrrrrrrrrrrrrrrW
W.rcccccccccccccccrr...rrccccccccccccccW
W.rrrrrrrrrrrrrrrrrrrr...rrrrrrrrrrrrrrW
W.rqqqqqqqqqqqqqqqqqqqrr...rrqqqqqqqqqqW
W.rrrrrrrrrrrrrrrrrrrrrrrr...rrrrrrrrrrW
W.rcccccccccccccccccccccccrr...rrccccccW
W.rrrrrrrrrrrrrrrrrrrrrrrrrrrr...rrrrrrW
W.wqwqwqwqwqwqwqwqwqwqwqwqwqwqrr...rrqqW
W.wrwrwrwrwrwrwrwrwrwrwrwrwrwr..rr...rrW
W.................................rr..PW
WWWWWWWWWWWWWWWWWWWWWWWWWWWWWWWWWWWWWWWW
[/map]
[/cave]

[cave]
Name=Cave 10
Intermission=true
CaveDelay=3
CaveTime=30
DiamondsRequired=10
DiamondValue=10 20
MagicWallTime=20
Colors=Black Black Brown Green Red

[map]
WWWWWWWWWWWWWWWWWWWW
W.rrrrrrrrrrrrrrrr.W
X.................PW
W.MMMMMMMMMMMMMMMM.W
W.qqqqqqqqqqqqqqqq.W
W.  w  w    w  w  .W
W. w w  w  w  w w .W
W.                .W
W.                .W
W.                .W
W.cccccccccccccccc.W
WWWWWWWWWWWWWWWWWWWW
[/map]
[/cave]

[cave]
Name=Cave 11
CaveDelay=8
CaveTime=100
DiamondsRequired=99
DiamondValue=1 3
Colors=Black Black Orange Red White

[map]
WWWWWWWWWWWWWWWWWWWWWWWWWWWWWWWWWWWWWWWW
WrWrWrWrWrWrWrWrWrWrWrWrWrWrWrWrWrWrWrWW
WcWcWcWcWcWcWcWcWcWcWcWcWcWcWcWcWcWcwcwW
W . . . . . . . . . . . . . . W W w w wW
W . . . . . . . . . . . . . W W w w wwwW
W . . . . . . . . . . . . W W w w wwwcWW
W . . . . . . . . . . . W W w w wwwcW WW
W . . . . . . . . . . W W w w wwwcW W .W
W . . . . . . . . . W W w w wwwcW W . .W
W . . . . . . . . W W w w wwwcW W . . .W
W . . . . . . . W W w w wwwcW W . . . .W
W . . . . . . W W w w wwwcW W . . . . .W
W . . . . . W W w w wwwcW W W . . . . .W
W . . . . W W w w wwwcw w W W W W . . .W
W . . . W W w w wwwcw w w w w W W W W .W
W . . W W w w wwwcP w w w w w w w W W WW
W . W W w w wwwcW W W W w w w w w w w WW
W W W w w wwwcW w W W W W W w w w w w wW
W W w w wwwcW w w W W . W W W W w w w wW
W w w wwwcW w w w w w W W W W W W W w wX
W w www W w w w w w w W W W W W W W W WW
WWWWWWWWWWWWWWWWWWWWWWWWWWWWWWWWWWWWWWWW
[/map]
[/cave]

[cave]
Name=Cave 12
CaveDelay=7
CaveTime=90
DiamondsRequired=30
DiamondValue=4 6
Colors=Black Black Orange Blue Yellow

[map]
WWWWWWWWWWWWWWWWWWWWWWWWWWWWWWWWWWWWWWWW
WrrrrrrrrrrrrrrrrrrrrrrrrrrrrrrrrrrrrrrX
W......................................W
W                                      W
W  q q q q q q q q q q q q q q q q q q W
W   c c c c c c c c c c c c c c c c c cW
W  q q q q q q q q q q q q q q q q q q W
W   c c c c c c c c c c c c c c c c c cW
W  q q q q q q q q q q q q q q q q q q W
W   c c c c c c c c c c c c c c c c c cW
W  q q q                               W
W   c c c                              W
W  q q q  P                            W
W   c c c                              W
W  q q q q q q q q q q q q q q q q q   W
W   c c c c c c c c c c c c c c c c c  W
W  q q q q q q q q q q q q q q q q q   W
W   c c c c c c c c c c c c c c c c c  W
W                                      W
W                                      W
W                                      W
WWWWWWWWWWWWWWWWWWWWWWWWWWWWWWWWWWWWWWWW
[/map]
[/cave]

[cave]
Name=Cave 13
CaveDelay=8
CaveTime=160
DiamondsRequired=99
DiamondValue=2 3
MagicWallTime=68
Colors=Black Black Purple Orange White

[map]
WWWWWWWWWWWWWWWWWWWWWWWWWWWWWWWWWWWWWWW
WWWr.rr .rr .rr .rr .rr .rr .rr .rr ..W
WWWrWc. Wc. Wc. Wc. Wc. Wc. Wc. Wc. W.W
WWWrWr. Wr. Wr. Wr. Wr. Wr. Wr. Wr. W.W
WP..Wrr Wrr Wrr Wrr Wrr Wrr Wrr Wrr W.W
WWWMWrWMWrWMWrWMWrWMWrWMWrWMWrWMWrWMW.W
WWWcWrWcWrWcWrWcWrWcWrWcWrWcWrWcWrWcW.W
WWW WrW WrW WrW WrW WrW WrW WrW WrW W.W
WWW.WrW.WrW.WrW.WrW.WrW.WrW.WrW.WrW.W.W
WWWcWrWcWrWcWrWcWrWcWrWcWrWcWrWcWrWcW.W
WWW WrW WrW WrW WrW WrW WrW WrW WrW W.W
WWW.WrW.WrW.WrW.WrW.WrW.WrW.WrW.WrW.W.W
WWWcWrWcWrWcWrWcWrWcWrWcWrWcWrWcWrWcW.W
WWW WrW WrW WrW WrW WrW WrW WrW WrW W.W
WWW.WrW.WrW.WrW.WrW.WrW.WrW.WrW.WrW.W.W
WWWcWrWcWrWcWrWcWrWcWrWcWrWcWrWcWrWcW.W
WWW WrW WrW WrW WrW WrW WrW WrW WrW W.W
WWW.WrW.WrW.WrW.WrW.WrW.WrW.WrW.WrW.W.W
WWWqWrWqWrWqWrWqWrWqWrWqWrWqWrWqWrWqW.W
WWW .dW .dW .dW .dW .dW .dW .dW .dW ..W
WX...d...d...d...d...d...d...d...d....W
WWWWWWWWWWWWWWWWWWWWWWWWWWWWWWWWWWWWWWW
[/map]
[/cave]

[cave]
Name=Cave 14
CaveDelay=9
CaveTime=200
DiamondsRequired=30
DiamondValue=16 20
SlimePermeability=0.500
MagicWallTime=185
Colors=Black Black LightBlue Gray3 Red

[map]
WWWWWWWWWWWWWWWWWWWWWWWWWWWWWWWWWWWWWWWW
WrdrdrdrdrdrdrdrdrdrdrdrdrdrdrdrdrdrdrdW
WddddddddddddddddddddddddddddddddddddddW
WrrrrrrrrrrrrrrrrrrrrrrrrrrrrrrrrrrrrrrW
WddddddddddddddddddddddddddddddddddddddW
Wsssssssssssssssssssssssssssssssssssssss
X                                      W
W                                      W
W  q  q  q  q  q  q  q  q  q  q  q  q  W
W                                      W
W                                      W
W  q  q  q  q  q  q  q  q  q  q  q  q  W
W                                      W
W                                      W
W  q  q  q  q  q  q  q  q  q  q  q  q  W
W                                      W
W                                      W
W                                      W
W                                      W
W M   MM M  M M MM  M MMM  M   M MM M MW
W              P                       W
WWWWWWWWWWWWWWWWWWWWWWWWWWWWWWWWWWWWWWWW
[/map]
[/cave]

[cave]
Name=Cave 15
Intermission=true
CaveDelay=4
CaveTime=90
DiamondsRequired=10
DiamondValue=5 6
AmoebaTime=40
Colors=Black Black LightRed Cyan Yellow

[map]
WWWWWWWWWWWWWWWWWWWW
XdrdrdrdddrdrdrdrdrW
WcqcqcqcqcqcqcqcqcqW
WdrdrdrdddrdrdrdrdrW
WqcqcqcqcqcqcqcqcqcW
WdrdrdrdddrdrdrdrdrW
WcqcqcqcqcqcqcqcqcqW
WrrwwwwwwdrdrdrdrdrW
WqcwPa...qcqcqcqcqcW
WrrwwwwwwdrdrdrdrdrW
W........cqcqc.....W
WWWWWWWWWWWWWWWWWWWW
[/map]
[/cave]

[cave]
Name=Cave 16
CaveDelay=8
CaveTime=160
DiamondsRequired=80
DiamondValue=5 6
AmoebaTime=140
Colors=Black Black Orange Brown White

[map]
WWWWWWWWWWWWWWWWWWWWWWWWWWWWWWWWWWWWWWWW
W WaaaaaaaaaaaaaaaaaaaaaaaaaaaaaaaaaaWPX
W  WrWrWrWrWrWrWrWrWrWrWrWrWrWrWrWrWr  W
W WrqrqrqrqrqrqrqrqrqrqrqrqrqrqrqrqrqW W
W WwrwrwrwrwrwrwrwrwrwrwrwrwrwrwrwrwrW W
W  ..................................  W
W WrWrWrWrWrWrWrWrWrWrWrWrWrWrWrWrWrWW W
W WqrqrqrqrqrqrqrqrqrqrqrqrqrqrqrqrqrWWW
W WrwrwrwrwrwrwrwrwrwrwrwrwrwrwrwrwrwW W
W  ..................................  W
W WWrWrWrWrWrWrWrWrWrWrWrWrWrWrWrWrWrW W
WWWrqrqrqrqrqrqrqrqrqrqrqrqrqrqrqrqrqW W
W WwrwrwrwrwrwrwrwrwrwrwrwrwrwrwrwrwrW W
W  ..................................  W
W W..................................W W
WWWW W W W W W W W W W W W W W W W W W W
W rqrqrqrqrqrqrqrqrqrqrqrqrqrqrqrqrqr  W
W W W W W W W W W W W W W W W W W W WW W
W W W W W W W W W W W W W W W W W W WW W
W wwwWwWwWwWwWwWwWwWwWwWwWwWwWwWwWwWw  W
W WccccccccccccccccccccccccccccccccccW W
WWWWWWWWWWWWWWWWWWWWWWWWWWWWWWWWWWWWWWWW
[/map]
[/cave]

[cave]
Name=Cave 17
CaveDelay=8
CaveTime=200
DiamondsRequired=20
DiamondValue=30 0
Colors=Black Black Blue Orange Yellow

[map]
WWWWWWWWWWWWWWWWWWWWWWWWWWWWWWWWWWWWWWWW
WPWqW.WqW.WqW.rqW.WqW.WqW.WqW.rqW.WqW.dW
W.W W.r W.W W.W W.W W.W W.W W.W W.W W.dW
W.W W.W W.r W.W W.r W.W W.r W.W W.W W.dW
W.W W.W W.W w.W W.W W.r W.W w.W W.W W.dW
W.W W.W w.W WWW w.WWW.W W.W WWW W.r W.dW
W.r W.W WWW W.W W.WqW.W w.WWW.W W.W W.dW
W.W W.W W.WWW.r W.W W.W W.WqW.WWW.W W.dW
W.W W.W W.WqW.WWW.W W.W WWW W.rqW.W W.dW
W.W W.W w.r W.WqW.W W.W W.W W.W W.W W.dW
W.W w.W W.W W.W WWW W.W w.W W.W W.W W.dW
W.W W.W W.W w.W W.W W.W W.W W.W w.W W.dW
W.W W.W W.W WWW W.r W.W W.W W.W W.W W.dW
W.W W.W W.W W.r W.W w.W W.r W.W WWW w.dW
W.W W.WWW.W w.W W.W WWW W.W W.W W.W W.dW
W.W W.WqW.W W.W W.W W.WWW.W W.W w.W W.dW
W.W WWW W.W W.W W.W W.rqW.W W.W W.W W.dW
W.W W.r W.W W.W W.W W.W WWW w.W W.W W.dW
W.W w.W WWW W.W W.W w.W W.r W.W W.r W.dW
W.W W.W w.r W.W W.W W.W w.W W.W W.W W.dW
X.W W.W W.W W.W w.W W.W W.W W.W W.W W.dW
WWWWWWWWWWWWWWWWWWWWWWWWWWWWWWWWWWWWWWWW
[/map]
[/cave]

[cave]
Name=Cave 18
CaveDelay=8
CaveTime=60
DiamondsRequired=99
DiamondValue=3 4
Colors=Black Black Yellow Gray1 Green

[map]
WWWWWWWWWWWWWWWWWWWWWWWWWWWWWWWWWWWWWWWW
WPPrrqrrrc.Prr.rrrcrrrrrrcPXrrcrrPrrPrrW
W.rr..rrrrrcXrPrPXPrPrrrrPPrqrrrqPrPrPcW
Wrr.PPrqrPrcrP.PPrrrrPrPcrrqrrrrrrrrPrPW
Wrr.PrXr..XrqrX.qr.P.rrPc.PrrrrrXcrrPXrW
W.rrrX..PrPPrPrPr.r.rPrrrrPPrPPrXrrccrPW
WrqrPrP...rrrrccPPrPccrr.rr.qPrccrrrrPPW
WXrr.rXr.rcqcqrcrrrXqrrrrrcPPrrrXrcrrrPW
WrrrPrPrr.crr.rPPrrrrrrrr.crcPcrrrr.rrrW
WXrrrrqcPrrrP.rrrqrrr..rrrrrrrqPr.rrrrrW
WrPrcrrrXrrPrrrr.rPrXr.rrcrrPrPrcrrqrrqW
WrrXrccqrrr.rrrPqP.r.PPPrrXrrqrPPqr.Pr.W
Wrr.PrPrrrqPcr.rPrXrrrPPrcrrrPqrrXrrrrrW
WrrrPPqcr.rqq.PP.rrPrcrXrPrqrcrrPrrr..PW
WrcrPrXrrrX..rrrrr..qPrrPPrrrPXrr.rrrrcW
WrrrrXrq.rrrPr.r.P.Prr..qPrPr.rrXrc.XrPW
Wrcrc.qrXcr.rrPrr.rPP.rr.PPrqr.rrPrrrPqW
WrrqPrqPrXrcP.rcr.Prr.c.rqrPcr.rrrqXXqrW
Wrr.PrrrPrrrPrrPrrrr.cPrrrPrPrrcXPrPrrrW
Wrrr..rrcrqrqPrqrP..rrrccrrrrrrrrqXrPXrW
Wr.rr.crr.rrPPXrrr.rrrPrrrrrXrrPPPccrrrW
WWWWWWWWWWWWWWWWWWWWWWWWWWWWWWWWWWWWWWWW
[/map]
[/cave]

[cave]
Name=Cave 19
CaveDelay=5
CaveTime=15
DiamondsRequired=2
DiamondValue=99 0
Colors=Black Black Yellow LightRed Cyan

[map]
WWWWWWWWWWWWWWWWWWWWWWWWWWWWWWWWWWWWWWWW
W.wrwrwrwrwrwrwrwrwrdrwrwrwrwrwrwrwrwrdW
W..q.q.q.q.q.q.q.q.q.q.q.q.q.q.q.q.q.q.W
W.wrwrwrwrwrwrwrwrwrwrwrwrwrwrwrwrwrwrwW
W..q.q.q.q.q.q.q.q.q.q.q.q.q.q.q.q.q.q.W
W.wrwrwrwrwrwrwrwrwrwrwrwrwrwrwrwrwrwrwW
W..q.q.q.q.q.q.q.q.q.q.q.q.q.q.q.q.q.q.W
W.wrwrwrwrwrwrwrwrwrwrwrwrwrwrwrwrwrwrwW
W..q.q.q.q.q.q.q.q.q.q.q.q.q.q.q.q.q.q.W
W.wrwrwrwrwrwrwrwrwrwrwrwrwrwrwrwrwrwrwW
W..q.q.q.q.q.q.q.q.q.q.q.q.q.q.q.q.q.q.W
W.wrwrwrwrwrwrwrwrwrwrwrwrwrwrwrwrwrwrwW
W..q.q.q.q.q.q.q.q.q.q.q.q.q.q.q.q.q.q.W
W.wrwrwrwrwrwrwrwrwrwrwrwrwrwrwrwrwrwrwW
W..q.q.q.q.q.q.q.q.q.q.q.q.q.q.q.q.q.q.W
W.wrwrwrwrwrwrwrwrwrwrwrwrwrwrwrwrwrwrwW
W..q.q.q.q.q.q.q.q.q.q.q.q.q.q.q.q.q.q.W
W.wrwrwrwrwrwrwrwrwrwrwrwrwrwrwrwrwrwrwW
W..q.q.q.q.q.q.q.q.q.q.q.q.q.q.q.q.q.q.W
W.wrwrwrwrwrwrwrwrwrwrwrwrwrwrwrwrwrwrwW
X.....................................PW
WWWWWWWWWWWWWWWWWWWWWWWWWWWWWWWWWWWWWWWW
[/map]
[/cave]

[cave]
Name=Cave 20
Intermission=true
CaveDelay=2
CaveTime=50
DiamondsRequired=10
DiamondValue=20 25
SlimePermeability=0.500
AmoebaTime=40
Colors=Black Black Gray3 Red Purple

[map]
WWWXWWWWWWWWWWWXWWWWWWWWWWWWWWWWWWWWWWW
Wa.c..a....a...c..aWWrWrWrWrWrWrWrWrWrW
W.   ...c.....   ..WWsWsWsWsWsWsWsWsWsW
W     .   ...    c.WWqWqWqWqWqWqWqWqWqW
c          .     ..WW W W W W W W W W W
W               ..aWW W W W W W W W W W
W.       P       ..WWWWWWWWWWWWWWWWWWWW
W..               .WWrWrWrWrWrWrWrWrWrW
W...   .     .    cXWsWsWsWsWsWsWsWsWsW
W....c...   ...   .WWqWqWqWqWqWqWqWqWqW
Wa.....a..c..a..c..WW W W W W W W W W W
WWWWWXWWWWXWWWWWXWWWW W W W W W W W W W
WWWWWWWWWWWWWWWWWWWWWWWWWWWWWWWWWWWWWWW
WrWrWrWrWrWrWrWrWrWrWrWrWrWrWrWrWrWrWrW
WsWsWsWsWsWsWsWsWsWsWsWsWsWsWsWsWsWsWsW
WqWqWqWqWqWqWqWqWqWqWqWqWqWqWqWqWqWqWqW
W W W W W W W W W W W W W W W W W W W W
W W W W W W W W W W W W W W W W W W W W
W W W W W W W W W W W W W W W W W W W W
W W W W W W W W W W W W W W W W W W W W
W W W W W W W W W W W W W W W W W W W W
WWWWWWWWWWWWWWWWWWWWWWWWWWWWWWWWWWWWWWW
[/map]
[/cave]
[/game]
[/BDCFF]
