; Converted using Tim Stridmann's X2BDCFF converter.
; Last modified: 9 July 2006

[BDCFF]
[game]
Name=FireFox 52
Author=FireFox
Date=12.11.2004
WWW=http://www.firefox.ch
Charset=Original
Fontset=Original
Levels=1
Caves=20

[cave]
Name=Cave 1. Entry3
CaveDelay=8
CaveTime=120
DiamondsRequired=30
DiamondValue=2 5
Colors=Green Black Orange LightRed Green

[map]
WWWWWWWWWWWWWWWWWWWWWWWWWWWWWWWWWWWWWWWW
W......W.W W.W....W...... ...W.......W.W
W......... .W.....W.W...W ..Wd.. ......W
W...WW..W. W...W....W...W W..W.. .W....W
W......Wd. dW..dW.W...W.. W..... .dW.W.W
W.......W. W.W.W.Wd..Wd. qdW.W.. .W....W
W......... ..W....W..dW. .W..dW. ....W.W
W.W..W.... W......W..Wd. ....W. qWW..W.W
W.dW.dW... dW.W..W...dW. ...... .......W
W.W..W.... W..dW..W..W..W..W.W. ..W....W
W.W......  W..W.....WW .W.Wd dW ..dW.W.W
WP...W... .....WW..Wd. W...W W. ..W....W
W.W...W.. ..W...W...W. dW... .. .......W
W..WW.dW.q.Wd.W..W.... W..W. .W...W....W
W.....W.. ..W.dW.WWW. q...dW ...W......W
W...W.... ....W...... ....W. .....W....W
W..Wd...W  W......... W..... qW..WWWW..W
W...W...dW W......... dW...W. .........W
W.W...W.W. ...W...W.. W...Wd. .WWWWW...W
WWd..Wd... ..Wd...dW. .....W. ..WX.....W
W.W...W... ...WW..W.. ..W.... .W...W...W
WWWWWWWWWWWWWWWWWWWWWWWWWWWWWWWWWWWWWWWW
[/map]
[/cave]

[cave]
Name=Cave 2. Cse1
CaveDelay=8
CaveTime=200
DiamondsRequired=69
DiamondValue=0 2
AmoebaTime=200
Colors=Gray1 Black Gray2 Green Yellow

[map]
WWWWWWWWWWWWWWWWWWWWWWWWWWWWWWWWWWWWWWWW
WaW                                  WaW
WaW                                  WaW
WaW                                  WaW
W W                                  W W
W                                      W
W                                      W
W            WWWW   WWW  WWWWW         W
W           Wccc.  Wcc.  Wccc.         W
W          Wcccc.  Wcc.  Wccc.         W
W          Wcccc.  Wcc.  Wccc.         W
W          Wcccc.P .WW.  XWWWW         W
W          Wcccc.  .ccW  Wccc.         W
W          WWccc.  .ccW  Wccc.         W
W            WWWW  .ccW  Wccc.         W
W                  WWW   WWWWW         W
W                                      W
W W                                  W W
WaW                                  WaW
WaW                                  WaW
WaW                                  WaW
WWWWWWWWWWWWWWWWWWWWWWWWWWWWWWWWWWWWWWWW
[/map]
[/cave]

[cave]
Name=Cave 3. Harm
CaveDelay=8
CaveTime=50
DiamondsRequired=24
DiamondValue=4 0
Colors=Gray1 Gray1 Black LightGreen Yellow

[map]
WWWWWWWWWWWWWWWWWWWWWWWWWWWWWWWWWWWWWWWW
W....rrrrrrrr...d......d...rrrrrrrr....W
W.rr.rrrrrr........dd........rrrrrr.rr.W
W.rr.rrrr...d....rr..rr....d...rrrr.rr.W
W.rr.rr........rrrr..rrrr........rr.rr.W
Wdrr....d....rrrrrr..rrrrrr....d....rr.W
W.rr.d.....rrrrrrrr..rrrrrrrr.......rrdW
W.rr.....rrrrrrrrrr..rrrrrrrrrr...d.rr.W
W.rr...rrrrrrrrrrrrXPrrrrrrrrrrrr...rr.W
W.rr.rrrrrrrrrrrrrrrrrrrrrrrrrrrrrr.rr.W
Wdrr...rrrrrrrrrrrrrrrrrrrrrrrrrr...rrdW
W.rr.....rrrrrrrrrrrrrrrrrrrrrr.....rr.W
W.rr..d....rrrrrrrrrrrrrrrrrr....d..rr.W
W.rr.........rrrrrrrrrrrrrr.........rr.W
W.rr.rr...d....rrrrrrrrrr....d...rr.rr.W
Wdrr.rrrr........rrrrrr........rrrr.rr.W
W.rr.rrrrrr...d....rr....d...rrrrrr.rrdW
W.rr.rrrrrrrr..............rrrrrrrr.rr.W
W.rr.rrrrrrrrrr...d..d...rrrrrrrrrr.rr.W
W.rr.rrrrrrrrrrrr......rrrrrrrrrrrr.rr.W
W....rrrrrrrrrrrrrr..rrrrrrrrrrrrrr....W
WWWWWWWWWWWWWWWWWWWWWWWWWWWWWWWWWWWWWWWW
[/map]
[/cave]

[cave]
Name=Cave 4. Reika2
CaveDelay=8
CaveTime=150
DiamondsRequired=80
DiamondValue=1 2
SlimePermeability=0.125
MagicWallTime=200
Colors=LightGreen Black LightBlue LightGreen Green

[map]
WWWWWWWWWWWWWWWWWWWWWWWWWWWWWWWWWWWWWWWW
WrrrrrrrrrrrrrrrrrrrrrrrrrrrrrrrrrrrrrrW
WrrrrrrrrrrrrrrrrrrrrrrrrrrrrrrrrrrrrrrW
WrrrrrrrrrrrrrrrrrrrrrrrrrrrrrrrrrrrrrrW
WssssssssssssssssssssssssssssssssssssssW
W                                      W
W sMsMsMsMsMsMsMsMsMsMsMsMsMsMsMsMsMsM W
W                   c                  W
W MsMsMsMsMsMsMsMsMsMsMsMsMsMsMsMsMsM  W
W                                      W
W  w w w w w w w w w w w w w w w w w   W
W s s s s s s s s s s s s sqs s s s s  W
X                                      W
W w w w w w w w w w w w w w w wPw w w  W
W                                      W
W                                      W
W MsMsMsMsMsMsMsMsMsMsMsMsMsMsMsMsMsM  W
W                        c             W
W sMsMsMsMsMsMsMsMsMsMsMsMsMsMsMsMsMs  W
W                                      W
W                                      W
WWWWWWWWWWWWWWWWWWWWWWWWWWWWWWWWWWWWWWWW
[/map]
[/cave]

[cave]
Name=Cave 5. Int205
Intermission=true
CaveDelay=0
CaveTime=20
DiamondsRequired=10
DiamondValue=10 0
Colors=Blue Purple White Black Blue

[map]
WWWWWWWWWWWWWWWWWWWW
W...W...Wd.........W
W.W.W.W.WdWWWWWWWW.W
W.W.W.W.WdW........W
W.W.W.W.WdW.WWWWWWWW
W.W.W.W.WdW........W
W.W.W.W.WdWWWWWWWW.W
W.W.W.W.WdW........W
W.W.W.W.WdW.WWWWWWWW
W.W.W.W.WdW...W...XW
WPW...W.ddW.W...W..W
WWWWWWWWWWWWWWWWWWWW
[/map]
[/cave]

[cave]
Name=Cave 6. Trap2
CaveDelay=8
CaveTime=200
DiamondsRequired=40
DiamondValue=2 3
Colors=Blue Black Green Purple Yellow

[map]
WWWWWWWWWWWWWWWWWWWWWWWWWWWWWWWWWWWWWWWW
X..wdw.....wrw.wdw..w..........wrw.wrw.W
W...w..wdw......w.......w..wdw.....wrw.W
WP......w..wdw......w..wrw.wdw.wdw.....W
W...w.......w...w..wrw.wrw.wdw.wdw.wdw.W
W..wrw..w......wrw.wrw......w..wdw.wdw.W
W......wrw..w..wrw.....wdw......w..wdw.W
W..wdw.....wrw.....wdw.wdw..w.......w..W
W...w..wdw.....wdw.wdw..w..wrw..w......W
W.......w..wdw.wdw..w......wrw.wrw..w..W
W...w.......w...w.......w..wrw.wrw.wrw.W
W..wrw..w...........w..wrw.....wrw.wrw.W
W......wrw..w...w..wrw.wrw.wdw.....wrw.W
W..wdw.....wrw.wrw.wrw.....wdw.wdw.....W
W...w..wdw.....wrw.....wdw.wdw.wdw.wdw.W
W.......w..wdw.....wdw.wdw..w..wdw.wdw.W
W...w.......w..wdw.wdw..w.......w..wdw.W
W..wrw..w......wdw..w.......w.......w..W
W......wrw..w...w.......w..wrw..w......W
W..wdw.....wrw......w..wrw.wrw.wrw..w..W
W...w..wdw......w..wrw.wrw.wrw.wrw.wrw.W
WWWWWWWWWWWWWWWWWWWWWWWWWWWWWWWWWWWWWWWW
[/map]
[/cave]

[cave]
Name=Cave 7. Fox2
CaveDelay=8
CaveTime=170
DiamondsRequired=77
DiamondValue=1 5
Colors=LightBlue Black Gray1 Blue Purple

[map]
WWWWWWWWWWWWWWWWWWWWWWWWWWWWWWWWWWWWWWWW
WdW...... d..w.........................W
Wdx..... ddd.x............... W........W
Wdxxx...Wxxw.x.............. dx........W
W...x.... ..Wx......... w.. ddx......w.W
W...Wx... ............ dx..wxxx......x.W
W....x... ........... ddx............x.W
W....x...c.......... dddxd ..........x.W
W....w... .......w. ddddxdd .........x.W
W........ .......xxxxxxxwddd ...W....x.W
W........ .....W..ddd ..xxxxxxw.W....x.W
W........ .....x.ddddd .w.......x....x.W
W.....W...wx...xxxxxxw..w.......x....x.W
W.xw..x....x...... ....wx..... dx....x.W
W.WxWxx....x...... .......... ddx....x.W
W.. d .....Wxxxx..c......... dddx....x.W
W. ddd ..w.....x.. ........ ddddx....x.W
WwxxxxxWxx.....x.. ....... dddddx....x.W
Wd   ..........x.. .......wxxxxxx....xPW
Wdd   .........x.. ......   ddd   ...xWW
Wddd   .......Ww.. .....   ddddd   WXWqW
WWWWWWWWWWWWWWWWWWWWWWWWWWWWWWWWWWWWWWWW
[/map]
[/cave]

[cave]
Name=Cave 8. Jail5
CaveDelay=8
CaveTime=120
DiamondsRequired=45
DiamondValue=2 4
Colors=Orange Black Yellow Brown Blue

[map]
WWWWWWWWWWWWWWWWWWWWWWWWWWWWWWWWWWWWWWWW
WrrrWrrrrrrWrrrWdddddddddWrrrWrrWrrrrrrW
WrrWrrrrrrrrWrrrWrrrrrrrWrrrWWrrrWrrrrrX
WPWrrrrrrrrWrWrrdWrrrrrWdrrWrrWrrdWrrrrW
WddrrrrrrrWrrrWrddrrrrWrdrWrWrrWrdrWrrrW
WddrrrrrrWrWrrdWddrrrWrrdWdrWrrrWdrr..rW
WWddddddWrrrWrddWdrrWrrrWrdrWWrrdWrr..rW
W.WddddWrrrrrWddrrrrrrrWrrdW..WrdrWr..rW
W.WWddWrrrrrrrWdrrrrrrWrrrW....WdrrW..rW
W.W....W......rrrrrrrrrrrrW.....Wrr....W
W.W....W.W.......................Wr....W
W.W....W.W.............................W
W.W....W.W..........W..................W
W.W....W.W..........W..................W
W.W....W.W..........W...WrrrddW........W
W.W....W.WWW........W....WrrddrW.......W
W......Wr..WWWW.....W.....WrrddrW......W
W......Wr...rrW.....W......WrddrrW.....W
W......WWWW.rrW.....W.......WrddrrW....W
W.........W.rrW.....W........WddrrrW...W
W...........rrW.....W.........WdrrrrW..W
WWWWWWWWWWWWWWWWWWWWWWWWWWWWWWWWWWWWWWWW
[/map]
[/cave]

[cave]
Name=Cave 9. Ordinary
CaveDelay=8
CaveTime=100
DiamondsRequired=20
DiamondValue=5 7
Colors=LightRed Black LightBlue Gray1 Purple

[map]
WWWWWWWWWWWWWWWWWWWWWWWWWWWWWWWWWWWWWWWW
Ww.r..rrw..r.r.r...wr..r.r...r.r......PW
W....r.w..r..r.r..r.r...w...dr.w.r.r.w.W
W........drw.r..rrw......wd..r.w....rw.W
Ww....rr..wrrdd.r.r.......w.....w..r...W
Ww.....d.w d.rrw...r..rrw..r..r......rrW
X.....w.r. .rwrwr....d...r.w.......ddr.W
Wr...d.... ..w.r.rrw..d.r..w.wr..dww.d.W
W.dw..d... w wr.w.r.r.r..r.rr......r...W
W.wrw..r.. r ..drd.rrr.w.wr.r...w.r.dr.W
Wrrw...... . .q.w.r.r....w.rd...rr.....W
W..drdr... r . .d.r..r...w.....r.rdw...W
W.rwr.r.d.q. . dr w.w...r.....r....w.r.W
W..rr....r r . ..w.d r.r..r....wrd..w..W
Wr..wr.wr. . . .. ..q.r....w.r.w..r.rd.W
W.rr.rr..rw.qw w.q.. .wr......r.rd.rrrwW
Ww....rr.r . .r.. .. ..ww.r.r.....w..wrW
W..rdr.rw. . .w.. ..ww. .w.w.r..r.wrrr.W
Wrrw.rd.wrqw .w.rw.. ..q..d...r.ww...r.W
Wd.r..rrw. .ww .. ..q.. .d.r.r..rd.r..rW
Www.r..... . .q..qr. .. .w..d..ww.dr...W
WWWWWWWWWWWWWWWWWWWWWWWWWWWWWWWWWWWWWWWW
[/map]
[/cave]

[cave]
Name=Cave 10. Int206
Intermission=true
CaveDelay=5
CaveTime=50
DiamondsRequired=9
DiamondValue=10 0
Colors=Red LightGreen Black Orange Red

[map]
WWWWWWWWWWWWWWWWWWWW
X....... r ........W
W.......r.r........W
W......r...r.......W
W.....r.....r......W
W....r.......r.....W
W...r.r.....r.r....W
W..r...r.r.r...r...W
WPr.....rdr.....r..W
Wr.....rdddr.....r.W
W.....rdddddr.....rW
WWWWWWWWWWWWWWWWWWWW
[/map]
[/cave]

[cave]
Name=Cave 11. Ahead3
CaveDelay=8
CaveTime=100
DiamondsRequired=34
DiamondValue=3 10
AmoebaTime=180
Colors=Green Black Yellow Red Green

[map]
WWWWWWWWWWWWWWWWWWWWWWWWWWWWWWWWWWWWWWWW
WdddW............aaaaWWW...........WdddW
Wddd.W..W........aaWWW.........W..W.dddW
WddW..W..W.......WWW..........W..W..WddW
WW..W..W..W......W...........W..W..W..WW
W.W..W..W..W.....W..........W..W..W..W.W
W..W..W..W..W....W.........W..W..W..W..W
W...W..W..W..W...WW..W....W..W..W..W...W
W....W..W..W..W...WW.W...W..W..W..W....W
W..W..W..W..W..W..W..W..W..W..W..W..W..W
W..W...W..W..W..W.W.WW.W..W..W..W...Wd.W
WPXWWW.....W....W.W..W.W....W.....WWWW.W
W..W...W..W..W..W.WW.W.W..W..W..W...Wd.W
W..W..W..W..W..W..W..W..W..W..W..W..W..W
W....W..W..W..W...W.WW...W..W..W..W....W
W...W..W..W..W....W..WW...W..W..W..W...W
W..W..W..W..W.........W....W..W..W..W..W
W.W..W..W..W..........W.....W..W..W..W.W
WW..W..W..W.........WWW......W..W..W..WW
Wdddd.W..W........WWWaa.......W..W.ddddW
WddddW..........WWWaaaa...........WddddW
WWWWWWWWWWWWWWWWWWWWWWWWWWWWWWWWWWWWWWWW
[/map]
[/cave]

[cave]
Name=Cave 12. Cut2
CaveDelay=8
CaveTime=150
DiamondsRequired=50
DiamondValue=2 6
SlimePermeability=0.125
MagicWallTime=130
Colors=Gray3 Gray1 Yellow Gray2 Black

[map]
WWWWWWWWWWWWWWWWWWWWWWWWWWWWWWWWWWWWWWWW
W......r...r.r...r.....r.rcc...........W
W...r..r.rr......rr.......ccr.r........W
W....r.....r.r.......r....cc..r.....r..W
W........r..r........r....cc......rr...W
W.......rr....rr........r.ccr.r......r.W
W.......r...r.r.r.........cc..r........W
W......r...r...r...rrr....cc.r......r..W
Wr............r..r..r.r...cc..........rW
W..WssssssW..r.r...r......ccr..rr.r.r.rW
W.rW      W....rr.........rr...rr......W
W..WMMMMMMW..............r..........r..W
W..r............r......rr..........r...W
W.....rr.........r...r.r....r..........W
W..............WssssssW........r.r.....W
W....r.r.......W      Wr.....r......r..W
W...rr.........WMMMMMMW.........r...rr.W
W....r...r..................WssssssW.r.W
W.r.....r.r..r............r.W      Wr..W
Wr..........................WMMMMMMW.r.W
X...................................Pr.W
WWWWWWWWWWWWWWWWWWWWWWWWWWWWWWWWWWWWWWWW
[/map]
[/cave]

[cave]
Name=Cave 13. Cross
CaveDelay=8
CaveTime=200
DiamondsRequired=60
DiamondValue=1 3
Colors=LightBlue Black Blue Gray1 Green

[map]
WWWWWWWWWWWWWWWWWWWWWWWWWWWWWWWWWWWWWWWW
W.................XWx...W..............W
W...................W.W.W....r..r......W
W...................W.W.W....WWWW......W
W........r..r.......W.W......WddW......W
W........WWWW.......W.W......WddW......W
W........WddW.......W.W......WddW......W
W........WddW.......W.W... q.wddw. q...W
W........WddW.......W.W.rWWWWqddqWWWWr.W
W.....q .wddw. q....W.W..WddddddddddW..W
W...rWWWWqddqWWWWr..W.W..WddddddddddW..W
W....WddddddddddW...W.W.rWWWWqddqWWWWr.W
W....WddddddddddW...W.W......wddw......W
W...rWWWWqddqWWWWr..W.W......WddW......W
W........wddw.......W.W......WddW......W
W........WddW.......W.W......WddW......W
W........WddW.......W.W......WWWW......W
W........WddW.......W.W......r..r......W
W........WWWW.......W.W.........P......W
W........r..r.......W.W................W
W.................W...xW...............W
WWWWWWWWWWWWWWWWWWWWWWWWWWWWWWWWWWWWWWWW
[/map]
[/cave]

[cave]
Name=Cave 14. Kiss4
CaveDelay=8
CaveTime=130
DiamondsRequired=55
DiamondValue=2 10
Colors=Green Black Orange Yellow White

[map]
WWWWWWWWWWWWWWWWWWWWWWWWWWWWWWWWWWWWWWWW
W................................rrrdddW
W................................rrrdddW
W................................rrrdddW
WrrrrrrrrrrrrrrrrrrrrrrrrrrrrrrrrrrrrrrW
WrrrrrrrrrrrrrrrrrrrrrrrrrrrrrrrrrrrrrrW
WrrrrrrrrrrrrrrrrrrrrrrrrrrrrrrrrrrrrrrW
W................................rrr...W
W................................rrr...W
W................................rrr...W
W................................rrr...W
W...................WWWWWWWWWWWWWWWWWWWW
W...................WrWrWrWrWrWrWrWrWrWW
W.....................................rW
WWWWWWWWWWWWWWWWWWWWWdWdWdWdWdWdWdWdWd.W
WrWWrWrWrWrWrWrWrWrWrWrWrWrWrWrWrWrWrW.W
W......................................W
W.WWdWdWdWdWdWdWdWdWdWdWdWdWdWdWdWdWdWdW
W.WrWrWrWrWrWrWrWrWrWrWrWrWrWrWrWrWrWrWW
W.....................................PW
WdWdWdWdWdWdWdWdWdWdWdWdWdWdWdWdWdWdWdXW
WWWWWWWWWWWWWWWWWWWWWWWWWWWWWWWWWWWWWWWW
[/map]
[/cave]

[cave]
Name=Cave 15. Int207
Intermission=true
CaveDelay=5
CaveTime=20
DiamondsRequired=9
DiamondValue=10 60
Colors=Gray1 Purple Gray2 Black Red

[map]
WWWWWWWWWWWWWWWWWWWWW
WrPrrr...rrr...rrrdXW
Wr.rrr.r.rrr.r.rrrdWW
Wr..rr.r.rrr.r.rrrdWW
Wrr.rr.r..rr.r..rrdWW
Wrr.rr.rr.rr.rr.rrdWW
Wrr..r.rr.rr.rr.rrdWW
Wrrr.r.rr..r.rr..rdWW
Wrrr.r.rrr.r.rrr.rdWW
Wrrr...rrr...rrr.rdWW
Wrrrrrrrrrrrrrrr..dWW
WWWWWWWWWWWWWWWWWWWWW
[/map]
[/cave]

[cave]
Name=Cave 16. Empire3
CaveDelay=8
CaveTime=170
DiamondsRequired=50
DiamondValue=1 3
AmoebaTime=200
Colors=Red Black Gray1 LightRed Yellow

[map]
WWWWWWWWWWWWWWWWWWWWWWWWWWWWWWWWWWWWWWWW
Wc.W...W...W..W............W..W......W W
WcW..W..W.W....W..WWW..W....W....W..W. W
Wc..W........W..W.....W.W.W..W..WWW... W
Wc.W..W..WW.WWW...W..W....W...W.....W. W
WcW..W.W.........W........W..W...W..W. W
Wc.......W..W.W.W..WWW..W...W.....W... W
Wc.WWW..W..W...W.........W..W.WWW..WW. W
Wc.....W........W..W.W....W.......W... W
Wc....W..W....W...W...W.W..W..W....W.. W
Wc..W..W..W..W...W.aa...W....W..W.....cW
Wc.W..W..W.W...W...aa.W.W..WW..W..W.W.cW
W W.....W...W.WW.....W....W...W..W...WcW
W ..W.W...W....W.W..W....W.W...W...P..cW
W .W...W.W..W.........W.W...W....W...WcW
W W...W.W..W..W..WWWW..W.....W.W..W.W.cW
W ...W.........W......W.W.W....W......cW
W W.W...WWWW....W..W......WW...W.W..WWcW
W W...W.......W...W..WWWW.W..W.W..W...cW
W W...W.X..WW.W..W....W.....W....W.W..cW
W ....W..W....W.....W...W..W....W.....cW
WWWWWWWWWWWWWWWWWWWWWWWWWWWWWWWWWWWWWWWW
[/map]
[/cave]

[cave]
Name=Cave 17. Queen6
CaveDelay=8
CaveTime=150
DiamondsRequired=25
DiamondValue=5 10
Colors=Gray2 Black Cyan Gray2 Yellow

[map]
WWWWWWWWWWWWWWWWWWWWWWWWWWWWWWWWWWWWWWWW
W.....r..........r........r............W
W.....r..........r........r............W
W.....r..........r........r............W
W.....r..........r.......Pr............W
W.....r..........r........r............W
W...rr.r.........r........r............W
W..r....r.......r.r.....rr.r...........W
W.r......r.....r...r...r....r..........W
Wr........r...r.....r.r......r.........W
W.r........r.r.......r........r........W
W..r........r.......r.r........r.......W
W...r......r.r.....r...r......r.r......W
W....r....r...r...r.....r....r...r.....W
W.....r..r.....r.r.......r..r.....r....W
W......rr.......r.........rr.......r...W
W......rr......rdr........rr........r..W
W.....rddr....rdddr......rddr........r.W
W....rddddr..rdddddr....rddddr........rW
W...rddddddrrdddddddr..rddddddr........W
W..rdddddddrdddddddddrrddddddddr.......X
WWWWWWWWWWWWWWWWWWWWWWWWWWWWWWWWWWWWWWWW
[/map]
[/cave]

[cave]
Name=Cave 18. Nubis1
CaveDelay=8
CaveTime=120
DiamondsRequired=25
DiamondValue=4 10
Colors=Red Black LightRed Green White

[map]
WWWWWWWWWWWWWWWWWWWWWWWWWWWWWWWWWWWWWWWW
W..........q...........................W
W.........q....www........r..........r.W
W..............wcw.....................W
W..............wwwqr........r..........W
W......r...r.q....................q....W
W............www..............r..www...W
W............wcw....r...r..www...wcw...W
W...........rwww......rr...wcw...www...W
W..www.....................www.r.....q.W
W..wcw..........www..............q.....W
W..www..........wcw............q...rq..W
W.www.r.........wwwww.qq........wwwr...W
X.wcw.............wcwwww........wcw....W
W.www.q.....q.....wwwwcw........www....W
W....................www.r.............W
W...r.www...q....................q...r.W
W....rwcw.......................q..www.W
W.....www.r.........r.......P......wcw.W
W............................r.....www.W
W......r....q.r........................W
WWWWWWWWWWWWWWWWWWWWWWWWWWWWWWWWWWWWWWWW
[/map]
[/cave]

[cave]
Name=Cave 19. Crazy2
CaveDelay=8
CaveTime=160
DiamondsRequired=90
DiamondValue=1 3
Colors=Green Black Cyan Gray1 Green

[map]
WWWWWWWWWWWWWWWWWWWWWWWWWWWWWWWWWWWWWWWW
W......................................W
W....r.....r.....................rrr...W
W....cr...rc...................rrrXrrr.W
W....ccr.rcc...................rqqqqqr.W
W....cccrccc...................rqqqqqr.W
W....ccr.rcc...................rqqqqqr.W
W....cr...rc....r.....r........rqqqqqr.W
W....r.....r....cr...rc........rqqqqqr.W
W...............ccr.rcc........rrrrrrr.W
W...r.....r.....cccrccc................W
W...cr...rc.....ccr.rcc.....rrrrrrr....W
W...ccr.rcc.....cr...rc.....rqqqqqr....W
W...cccrccc.....r.....r.....rqqqqqr....W
W...ccr.rcc.................rqqWqqr...PW
W...cr...rc.................rqqqqqr....W
W...r.....r.................rqqqqqr....W
W...........................rrrrrrr....W
W......................................W
W......................................W
W......................................W
WWWWWWWWWWWWWWWWWWWWWWWWWWWWWWWWWWWWWWWW
[/map]
[/cave]

[cave]
Name=Cave 20. Int208
Intermission=true
CaveDelay=3
CaveTime=80
DiamondsRequired=50
DiamondValue=0 3
AmoebaTime=20
Colors=Black Blue Green LightRed Red

[map]
WWWWWWWWWWWWWWWWWWWW
Xr.......a........rW
Wr................rW
Wr................rW
Wr................rW
Wr.......q........rW
Wr......qrq.......rW
Wr.....qr.rq......rW
Wr....qr...rq.....rW
Wr...qr.....rq....rW
Wr..qr...P...rq...rW
WWWWWWWWWWWWWWWWWWWW
[/map]
[/cave]
[/game]
[/BDCFF]
