; Converted using Tim Stridmann's X2BDCFF converter.
; Last modified: 14 June 2006

[BDCFF]

[game]
Name=Santa's BD Party
Author=Arno Weber
Date=December 2004
WWW=http://www.boulder-dash.nl/
Charset=Santa
Fontset=Santa
Levels=1
Caves=20

[cave]
Name=Cave 1
CaveDelay=8
CaveTime=150
DiamondsRequired=14
DiamondValue=25 40
SlimePermeability=1.000
Colors=Black Black Green Red Yellow

[map]
WWWWWWWWWWWWWWWWWWWWWWWWWWWWWWWWWWWWWWWW
W                                      W
W                            s         W
W                            .         W
W     s     s               .r.        W
W                            .         W
W                          .w.d.       W
W  s     s     s            .ww        W
W                         ..r..d.      W
W                          .....       W
W     s     s            ..d..r...     W
W                         ...d.ww      W
W                       ..r..ww..d.    W
W  s     s     s         ..wwd.r..     W
W                      ..ww.r.....r.   W
W                       .d....w.d..    W
W                     .r...d...ww..d.  W
W                      .....r.d..ww.   W
W                           ...        W
W                     c   c  w   c   c W
X  P                c   c   cw c   c   W
WWWWWWWWWWWWWWWWWWWWWWWWWWWWWWWWWWWWWWWW
[/map]
[/cave]

[cave]
Name=Cave 2
CaveDelay=8
CaveTime=150
DiamondsRequired=20
DiamondValue=25 35
MagicWallTime=80
Colors=Black Black Yellow LightBlue White

[map]
WWWWWWWWWWWWWWWWWWWWWWWWWWWWWWWWWWWWWWWW
WPqr w  w  w     w     w ww r  r w     W
Wqq.   w     ww     w     w .  . w wr wW
WwqMww   ww wrww   w r w w  M wMw   . wW
W      w  r  .   w   . w w          M  W
Ww w  w   .  M w w   M    w w   w w  w W
W   w w  wM           w  w   w w  w w wW
W ww  ww    qw   ww      w w w www     W
W r w     w w   r w  www    w    w w   W
W .    w w w  w .     rw w  r        w W
W M w w  w r  w M   w .    w. w w w  w W
W        w .w  w  w w M w   M w   r w  X
W w r      M    w       q  w      .    W
W   .  ww       r w   w ww      w M   wW
Ww wM    w w  w . w  w   rw w w     w wW
W      w      w M     w  .ww      w  rwW
W ww  r w w w r  w w   w Mwr   w     . W
W     . rw    .   w  r     . ww  w w MrW
Ww  w M .  w wM w    .  w  M w   w   q.W
W w w   M ww w    w wM w w          wqMW
W   w w    w   w   w        w  ww w wqqW
WWWWWWWWWWWWWWWWWWWWWWWWWWWWWWWWWWWWWWWW
[/map]
[/cave]

[cave]
Name=Cave 3
CaveDelay=8
CaveTime=180
DiamondsRequired=75
DiamondValue=7 10
SlimePermeability=0.500
MagicWallTime=80
Colors=Black Black Purple Brown Yellow

[map]
WWWWWWWWWWWWWWWWWWWWWWWWWWWWWWWWWWWWWWWW
WddddddddddddddddddddddddddddddddddddddW
WssssssssssssssssssssssssssssssssssssssW
W                                     .W
W w w w w wW           W w w   wW .  rqW
Ww   w   w W w   .   w W      wdW .  W W
W.. ... ...W  w  P  w  W  w  wddW .  w W
Wc. .q. .c.W   w   w   W  r rwddW..  w W
W.. ... ...W    w w    W  . .wddW   wwwW
W          W           W  . .wwwW   wddW
W                         . .....   wddW
W sWsWsWsWWWsWWWW WWWWsWWWW WWWWWWW WWWW
W             r W       r r W dd    r wW
W M M M M   M W Ww      W W Wdwwd  MW wW
W               W.w     w w Ww  .   WcwW
W W WwW WwW W   ...w    wcw  .c .   WwwW
W . r r r r .   Wqq w   www W ..    Ww W
W .M. .M. .M.   W . .w  WMW W       WwcW
W               W . ..  W   W.r.r.  WwwW
W    c   c    c W . ..  W   W.r.r.  W wW
Wd              W   ..      Wdrdr. MWqwX
WWWWWWWWWWWWWWWWWWWWWWWWWWWWWWWWWWWWWWWW
[/map]
[/cave]

[cave]
Name=Cave 4
CaveDelay=8
CaveTime=120
DiamondsRequired=30
DiamondValue=18 25
SlimePermeability=1.000
Colors=Black LightBlue White LightRed White

[map]
WWWWWWWWWWWWWWWWWWWWWWWWWWWWWWWWWWWWWWWW
W                                      W
W                                   s  W
W            s              s          W
W      s                               W
W                   s                  W
W                                 s .. W
W                            ..     WWqW
W  s            s            WW     WW W
W     .    s         s       WWq  ..WW W
W    .w.                ..   WW.. WWWWqW
W   .wWw.               WW   WWWW WWWW.W
W   wWWWw               WW ..WWWWqWWWWWW
W    WWW                WW WWWWWW WWWWWW
W    XWWP               WW WWWWWWqWWWWWW
W....ccc.....................r...r...r.W
W.....cccc.......r......r......r....rr.W
W. ..cc..c. .. .... ........r.....r...rW
W..  .cc.c ....r.... ........r... ..r..W
W. .ccccc.cc.............. .......... .W
W...c.cc.cc c... .............. .r.....W
WWWWWWWWWWWWWWWWWWWWWWWWWWWWWWWWWWWWWWWW
[/map]
[/cave]

[cave]
Name=Cave 5
Intermission=true
CaveDelay=5
CaveTime=30
DiamondsRequired=16
DiamondValue=30 0
SlimePermeability=0.500
Colors=Black Black LightBlue Red White

[map]
WWWWWWWWWWWWWWWWWWXWWWWWWWWWWWWWWWWWWWWW
XP...............sPW...................W
Wsssssssssssssss.s.W...................W
W..............s.s.W...................W
W.ssssssssssss.s.s.W...................W
W.s...dddddddd.s.s.W...................W
W.s.s.dddddddd...s.W...................W
W.s.s.ssssssssssss.W...................W
W.s.s..............W...................W
W.s.sssssssssssssssW...................W
WPs...............PX...................W
WXWWWWWWWWWWWWWWWWWW...................W
W......................................W
W......................................W
W......................................W
W......................................W
W......................................W
W......................................W
W......................................W
W......................................W
W......................................W
WWWWWWWWWWWWWWWWWWWWWWWWWWWWWWWWWWWWWWWW
[/map]
[/cave]

[cave]
Name=Cave 6
CaveDelay=8
CaveTime=170
DiamondsRequired=25
DiamondValue=20 30
SlimePermeability=0.500
Colors=Black Blue Green Red White

[map]
WWWWWWWWWWWWWWWWWWWWWWWWWWWWWWWWWWWWWWWW
WddddddddddddddddddddddddddddddddddddddW
WssssssssssssssssssssssssssssssssssssssW
W                                      W
W   s               s                  W
W              s        s      s       W
W          s       s        s       s  W
W s                                    W
W     s              s           s     W
W             s                        W
W                        s             W
W                                      W
W   s     s     s     s     s     s    W
W   .     .     .     .     .     .    W
W   .     .     .     .     .     .    W
W  ... P ...   ...   ...   ...   ...   W
W  ...   ...   ...   ...   ...   ...   W
W ..... ..... ..... ..... ..... .....  W
W ..... ..... ..... ..... ..... .....  W
W  ...   ...   ...   ...   ...   ...   W
Wq  w  q  w  q  w  q  w  q  w  q  w    X
WWWWWWWWWWWWWWWWWWWWWWWWWWWWWWWWWWWWWWWW
[/map]
[/cave]

[cave]
Name=Cave 7
CaveDelay=8
CaveTime=160
DiamondsRequired=60
DiamondValue=10 15
AmoebaTime=30
Colors=Black Black Gray2 Red Yellow

[map]
WWWWWWWWWWWWWWWWWWWWWWWWWWWWWWWWWWWWWWWW
W                P                     W
W ..r..rr..W...r.W.d..rW.r...W...r.... W
W .dr.r....Wd..r.W...r.W..d.rW.r.r.r.r W
W r....rdr.W.r.d.Wrr..rW.dd..W..r...dr W
W WWWWWWWWWWWWWWWWWWWWWWWWWWWWWWWWWWWW W
W ..d....r.W                 W.....r.. W
W rr.r..r..W WWWWWWWWWWWWWWW W.dr....r W
W ...r.....W W wqqq      wqW Wr.rr..d. W
W ..r..d.r.W W  wwwrw wwrw WaW...r.r.. W
W WWWWWWWWr. WX  .... .... .rWWWWWWWWW W
W ....r....W W  wwwww wwww WaW...r.... W
W r.r.r.r..W Wcwccc      w W Wr....r.. W
W rr.......W WWWWWWWWWWWWWWW W.r.rdr.. W
W ...rd..r.W                 W.r...d.r W
W WWWWWWWWWWWWWWWWWWWWWWWWWWWWWWWWWWWW W
W ..d....r.W...r.Wrr..rWrr...W.d...r.r W
W r...r....W.r..rW..d..W...r.Wr.....rr W
W .r.rr.r..W.dr..W...rrW.r.rrW.rr.r... W
W ...r...r.W.d...W.r...W..r..W......r. W
W                                      W
WWWWWWWWWWWWWWWWWWWWWWWWWWWWWWWWWWWWWWWW
[/map]
[/cave]

[cave]
Name=Cave 8
CaveDelay=8
CaveTime=190
DiamondsRequired=42
DiamondValue=15 20
SlimePermeability=1.000
Colors=Black LightBlue White Orange White

[map]
WWWWWWWWWWWWWWWWWWWWWWWWWWWWWWWWWWWWWWWW
W..                                    W
W...         s          s    s         W
Ww...             s                 s  W
Wwww...         s                      W
WrW w...               s               W
WcW rrw...                       s     W
WrW W.rw...         s    s             W
W..qWWr.ww..                  s        W
WwW.Wrwdr.w..                        s W
Wqr.WcWdr.rw..              s          W
W W WrWdrWcWw...                       W
W W  .WdrWrWqw...                 s    W
WwW  WWWrW.  ww....            s       W
W..W rcWrWW   wr....                   W
Ww..WW Wrwdd   rww....              s  W
Wdw..W W..ddwW .rw.....                W
Wddw..WWWWWWWWWWr.www...               W
Wdddw..rqWdd.wqr.cr. w....             W
WddddwwW Wdd.w Ww WW ww....            W
Xddddd w Wdd.w ww W   qr.....         PW
WWWWWWWWWWWWWWWWWWWWWWWWWWWWWWWWWWWWWWWW
[/map]
[/cave]

[cave]
Name=Cave 9
CaveDelay=8
CaveTime=160
DiamondsRequired=70
DiamondValue=7 10
AmoebaTime=140
Colors=Black Black LightGreen Purple White

[map]
WWWWWWWWWWWWWWWWWWWWWWWWWWWWWWWWWWWWWWWW
X...rrqaarar.w. a q  d qq      a     c W
W.. rc   ar .w. a c    .   cd rqa  c a W
W. q crrd...www.   c  .w. r    r ar dr W
W c .    q.ww ww.a cr .w.           . rW
Wq d  a c ..www.     .www.   dq    .w..W
Wrq .  d  a..w. q c .ww ww.d ar  r .w. W
Wqq.w.r   d .w.c .  ..www.  P  r  .www.W
W  .w.    dr .    d aa.w. q. rd  .ww wwW
W .www.  r  a   ar  aa.w.c  .     .www.W
W.ww ww. d  q   cdrd   . . .w.c rq .w. W
W .www.q.     d  c. c  qc  .w.     .w. W
Wc .w. .w.r .qa  .   r .d .www. .c  .  W
Wrc.w.d.w.   dd .w.      .ww ww. r .c  W
W   . .www. q   .w.  ccc  .www.  c  .  W
W. a .ww ww.   .www. dd    .w.     d   W
W     .www.   .ww ww. qq  r.w.   r .   W
W    c .w.   q .www.        .  rr    dcW
Wcq    .w.   a  .w. a   c  r q  dd   q W
W       .    d  .w.  r    d r. qrc d  dW
W  c  .  c     q .        q c ..     dcW
WWWWWWWWWWWWWWWWWWWWWWWWWWWWWWWWWWWWWWWW
[/map]
[/cave]

[cave]
Name=Cave 10
Intermission=true
CaveDelay=3
CaveTime=20
DiamondsRequired=20
DiamondValue=25 30
MagicWallTime=10
Colors=Black Black Gray2 Orange Yellow

[map]
WWWWWWWWWWWWWWWWWWWWW
W.rrrrrrrrrrrrrrrr.WW
WP.................XW
W.MMMMMMMMMMMMMMMM.WW
W.                .WW
W.                .WW
W.                .WW
W.ccc             .WW
W.ccc         qqqq.WW
W.ccc         qqqq.WW
W.ccc         qqqq.WW
WWWWWWWWWWWWWWWWWWWWW
[/map]
[/cave]

[cave]
Name=Cave 11
CaveDelay=8
CaveTime=140
DiamondsRequired=50
DiamondValue=10 15
MagicWallTime=20
Colors=Black Black Orange Red White

[map]
WWWWWWWWWWWWWWWWWWWWWWWWWWWWWWWWWWWWWWWW
WdWrWdWdWdWdWdrddrdrddrdrWWdddrddrrddrdW
WrWdWrWrWdWrW.WrrddrrdddW WdrrdrrrdrrdrW
WrWdWdWrWrW.W  WddrddrdW   WddrddrrrdrdW
WdWrWdW.W.W     WdrrddW    WWrdrdrddrdrW
WrW.W.W   W      WddrW       WWrrdrrrddW
WdW   W   W    Wc WrW  Wc     WddrrddrrW
W.W            W   .   W       WrddrddrW
W              W       W       WW.W.W.WW
W              W       W               W
W              W       W               W
W     c        q   P   q           w   W
W         c    W       W             w W
W              W       W         w     W
W   c   c      W       W            M  W
W              W   w   W          w    W
W              W  w.w  W        M     wW
W                w.X.w                 W
W w   w w       wq . qw                W
W  w w   w    Ww q   q wW              W
W             .. q . q ..              W
WWWWWWWWWWWWWWWWWWWWWWWWWWWWWWWWWWWWWWWW
[/map]
[/cave]

[cave]
Name=Cave 12
CaveDelay=8
CaveTime=160
DiamondsRequired=99
DiamondValue=4 6
AmoebaTime=140
Colors=Black Blue White Orange Yellow

[map]
WWWWWWWWWWWWWWWWWWWWWWWWWWWWWWWWWWWWWWWW
X             a  aa aa  a              W
W                                      W
W                                      W
W                                      W
W                                      W
W                                      W
W                                      W
W                                      W
W                                      W
W                                      W
W                                      W
W      .           .           .       W
W     .w.         .w.         .w.      W
W    .w w.       .w w.       .w w.     W
W   .w   w.     .w   w.     .w   w.    W
W  .w     w.   .w     w. P .w     w.   W
W  wW     Ww   wW     Ww   wW     Ww   W
W   WcccccW     WcccccW     WcccccW    W
W...WcccccW.....WcccccW.....WcccccW....W
W... cccccW..... ccccc .....Wccccc ....W
WWWWWWWWWWWWWWWWWWWWWWWWWWWWWWWWWWWWWWWW
[/map]
[/cave]

[cave]
Name=Cave 13
CaveDelay=8
CaveTime=160
DiamondsRequired=40
DiamondValue=10 12
SlimePermeability=1.000
MagicWallTime=60
Colors=Black Black LightRed Gray1 Yellow

[map]
ssssssssssssssssssssssssssssssssssssssss
s   d      d      d      d      d      s
s   w      w      w      w      w      s
s  wWw    wWw    wWw    wWw    wWw     s
s wWWWw  wWWWw  wWWWw  wWWWw  wWWWw    s
sd XWX dd XWX dd XWX dd XWX dd XWX     s
sMMMMMMMMMMMMMMMMMMMMMMMMMMMMMMMMMMMMM.s
s..FF..F....F......F.......F........q.rs
s....F..FFF...F.F...F.F..F..Fr....F. ..s
sF.....F.....F...F...F.F..F......... .Ms
s.F..F...F.F..F....FF..FF..FF....... .ws
s......F.......F...........F..FFFFF. .ws
s.WWWWWWWWWWWWWWWWWWWWWWWWWWWWWWWWWWWWMs
s.xwd...w.dxw...xw.d....dxd.....wxdw.d.s
sd.x..x..x....x..x.w.w..x..xw.xd.x...xws
s.xd.wx....xdw.......dx...d....x...x..ds
s....x.dxw....xdwwdw.xd.wx..xwd.x.wwd.xs
sWWWWrWWWWWWWWrWWWWrWWWWWrWWrWWWWWWWWrWs
sP   .        .    .     .  .        . s
s                                      s
s     c        c    c     c  c        cs
WWWWWWWWWWWWWWWWWWWWWWWWWWWWWWWWWWWWWWWW
[/map]
[/cave]

[cave]
Name=Cave 14
CaveDelay=8
CaveTime=80
DiamondsRequired=60
DiamondValue=8 10
SlimePermeability=0.125
MagicWallTime=75
Colors=Black Black Cyan LightBlue White

[map]
WWWWWWWWWWWWWWWWWWWWWWWWWWWWWWWWWWWWWWWW
WrrrrrrrrrrrrrrrrrrrrrrrrrrrrrrrrrrrrrrW
WrrrrrrrrrrrrrrrrrrrrrrrrrrrrrrrrrrrrrrW
WssssssssssssssssssssssssssssssssssssssW
W              P                       X
W w      w       w  w       w         wW
W  w    w       w    w     w         w W
W   w  w  M    w      w   w    w    w  W
W     w       w  w     w      w  w     W
W    w     M      w     w    w    w    W
Ww  w       w      M w      w   M  w   W
W w    w     w      w      w        w  W
W     w            w.     w  w       w W
W  M w    w   M   w.     M    w       MW
Ww       w w     w  .w         w       W
W w     w.. w   w ..  w       . w     wW
W  w   w.. . w w  . ...w     w . w   w W
W.. w w   . .      .. . w   w. . .w w..W
W       .  .     ..  . . w w .. .    . W
W .       .    .   ...        . ..     W
W. .    ... .      ..  .      ..      .W
WWWWWWWWWWWWWWWWWWWWWWWWWWWWWWWWWWWWWWWW
[/map]
[/cave]

[cave]
Name=Cave 15
Intermission=true
CaveDelay=4
CaveTime=40
DiamondsRequired=10
DiamondValue=30 45
AmoebaTime=255
Colors=Black Black LightRed Red Yellow

[map]
WWWWWWWWWWWWWWWWWWWW
WP.......a........XW
W..................W
W........ .........W
W......     .......W
W.......   ........W
W...           ....W
W.....       ......W
W.                .W
W....ccccccccc.....W
W........c.........W
WWWWWWWWWWWWWWWWWWWW
[/map]
[/cave]

[cave]
Name=Cave 16
CaveDelay=8
CaveTime=160
DiamondsRequired=90
DiamondValue=5 6
SlimePermeability=0.500
Colors=Black Black LightRed Orange White

[map]
WWWWWWWWWWWWWWWWWWWWWWWWWWWWWWWWWWWWWWWW
W ddddddddddddddddddddq  cddddddXssssssW
W                  dddddddsssssss.x.dxdW
W           dddddddsssssss r      .x...W
W    dddddddsssssss   w r .c.    .x.dx.W
W dddsssssssr         w W .r.rrrr   dd W
W sss     r.c.    W W wcW  . ....dddss W
W   r.   .c.r.     W  wwW wwwsssssss.. W
W  .r    .r...    ....sssssss          W
W   r.    . . .sssssss              q. W
Wd .W   sssssss            q.  .     . W
Wsssssss          q.  .     .  .c      W
Wr       q.  .     .  .c         ssssssW
Wr. .     .  .c           sssssss      W
Wr  .c             sssssss   .qq. W W  W
Wr.         sssssss   .r.    .  .  W  rW
W.   ssssssswqr   d d .r.    .  .     .W
Wdsssdrrdr. w W WdWdW .r.    .  .   ss.W
Wddrdrdddr. w W  W W  .W.    sssssss   W
Wrrdddrdrd. w W       sssssss.drdrd.   W
Wdrdrddddr. w WsssssssP.......drdrd.c  W
WWWWWWWWWWWWWWWWWWWWWWWWWWWWWWWWWWWWWWWW
[/map]
[/cave]

[cave]
Name=Cave 17
CaveDelay=8
CaveTime=200
DiamondsRequired=65
DiamondValue=9 12
MagicWallTime=20
Colors=Black Black Orange Brown Yellow

[map]
WWWWWWWWWWWWWWWWWWWWWWWWWWWWWWWWWWWWWWWW
X    rW...rd..r q     q .dw............W
W    .Wdr...... W  W  W .dw..r.r.r..M..W
W     Wr.d..dr. W  W  W .dw...r.r..M...W
W     W.r.r.r.. W  W  W .dw..r.r..M....W
W     W.....r..    c    .dw...r..M....cW
W     W.rd...r..wwwwwwwwwww..r..M....cqW
W     W..d.r.d..rr..rr..wr.....MrWWWWWWW
W     Wr...r...drr..rr..w.....Mdr......W
W     Wr..rd...drr..rr..w....M.dr......W
W     W..r.....drr..rr..w......dr....P.W
W     W W......drr..rr..w......dr......W
W.....W. W.....drr..rr..w......dr......W
W     WW. W....drr..rr..w.......rWWWWWWW
W     W.W. W....rr..rr..w.............rW
W     W .W. W...wwwwwwwwwwwww.rr..drrd.W
W     W. .W. W..          .dw....r.r..dW
W     W W .W. W.    wqwqw .dwr.d..dr.r.W
W     W. W .W. W   wwwwww .dw...r.....rW
W     Wr. W .W. W  wqwqw  .dw.r...r..r.W
Wccccc.. . W . . W        .dw.d..rrr..dW
WWWWWWWWWWWWWWWWWWWWWWWWWWWWWWWWWWWWWWWW
[/map]
[/cave]

[cave]
Name=Cave 18
CaveDelay=8
CaveTime=255
DiamondsRequired=80
DiamondValue=6 10
AmoebaTime=250
MagicWallTime=250
Colors=Black Black Green Purple Yellow

[map]
WWWWWWWWWWWWWWWWWWWWWWWWWWWWWWWWWWWWWWWW
W                drdrdXdrdrdrdrdrdraaaaa
W      a                                
W      .           q     c              
W      .                                
W      .         c          c           
W     ...          w   w       w   w    
W     .c.         w     w  q  w     w   
W     .q.        w       w   w       w  
W    ..c..           M     M     M      
W    .cqc.             q       c        
W   ..qcq..                             
W   .qcqcq.          W  c  W     W      
W  ..cqcqc..        W W   W W   W W     
W  .cqcqcqc.     c                      
W ..qcqcqcq..       q         c    q    
W .qcqcqcqcq.                           
W ..qcqcqcq..            q    c         
W  ...cqc...        c                   
W    .....       M    M    M    M    M  
WP     w                                
WWWWWWWWWWWWWWWWWWWWWWWWWWWWWWWWWWWWWWWW
[/map]
[/cave]

[cave]
Name=Cave 19
CaveDelay=8
CaveTime=200
DiamondsRequired=99
DiamondValue=5 6
AmoebaTime=999
Colors=Black Black LightBlue Red Yellow

[map]
WWWWWWWWWWWWWWWWWWWWWWWWWWWWWWWWWWWWWWWW
XP.....................................W
W...ca.ca.ca.ca.ca.ca.ca.ca.ca.ca.ca.caW
W......................................W
W.c....................................W
W.a...r...r.qqqqq.cccc..dddd..W...W..c.W
W.....rr.rr.q.....c...c.d...d..W.W...a.W
W.c...r.r.r.qqq...cccc..dddd....W......W
W.a...r...r.q.....c..c..d..d....W....c.W
W.....r...r.qqqqq.c...c.d...d...W....a.W
W.c....................................W
W.a..................................c.W
W......w...w.....d...d...r....qqqq...a.W
W.c.....w.w......dd.dd..r.r..q.........W
W.a......w...ccc.d.d.d.r...r..qqq....c.W
W.......w.w......d...d.rrrrr.....q...a.W
W.c....w...w.....d...d.r...r.qqqq......W
W.a..................................c.W
W....................................a.W
W.c..ca.ca.ca.ca.ca.ca.ca.ca.ca.ca.caddW
W.a..................................ddW
WWWWWWWWWWWWWWWWWWWWWWWWWWWWWWWWWWWWWWWW
[/map]
[/cave]

[cave]
Name=Cave 20
Intermission=true
CaveDelay=3
CaveTime=30
DiamondsRequired=40
DiamondValue=15 18
SlimePermeability=0.250
Colors=Black Black Orange Blue White

[map]
sssssssssssssssssssWWWWWWWWWWWWWWWWWWWW
X X  X  XX  XX  X XWWWWWrWWWWrWrWrWrWrW
XXX X X X X X X X XWWWrW WrWW W W W W W
X X XXX XX  XX   X WWW W W WW W W W W W
X X X X X   X    X WrWqW W WW W W W W W
...................W WWW W WW W W W W W
Wddd.ddd.ddd.ddd..WW WrW W WWsWsWsWsWsW
W..d.d.d.d.d.d....WW W WqW WW W W W W W
Wddd.d.d.d.d.ddd..WWqW WWW WW W W W W W
Wd...d.d.d.d...d..WWWW WWW WW W W W W W
Wddd.ddd.ddd.ddd.PWWrW WrWqWW W W W W W
WWWWWWWWWWWWWWWWWWWW W W WWWWqWqWqWqWqW
WWrWrWrWrWrWrWrWrW W W W WrWWWWWWWWWWWW
WWsWsWsWsWsWsWsWsW W W W W WWrWrWrWrWrW
WW W W W W W W W W WsW W W WW W W W W W
WW W W W W W W W W W W W W WW W W W W W
WW W W W W W W W W W W WsWsWWsWsWsWsWsW
WW W W W W W W W W W W W W WW W W W W W
WW W W W W W W W W W W W W WW W W W W W
WW W W W W W W W W W W W W WW W W W W W
WWqWqWqWqWqWqWqWqW WqWqWqWqWWqWqWqWqWqW
WWWWWWWWWWWWWWWWWWWWWWWWWWWWWWWWWWWWWWW
[/map]
[/cave]
[/game]
[/BDCFF]
