; Converted using Tim Stridmann's X2BDCFF converter.
; Last modified: 14 January 2007

[BDCFF]
[game]
Name=Arno Dash 19
Author=Arno Weber
Date=October 2006
WWW=http://www.boulder-dash.nl/
Charset=Original
Fontset=Original
Levels=1
Caves=20

[cave]
Name=Cave 1
CaveDelay=8
CaveTime=140
DiamondsRequired=42
DiamondValue=10 20
Colors=Black Black Brown Blue Red

[map]
WWWWWWWWWWWWWWWWWWWWWWWWWWWWWWWWWWWWWWWW
W.d.......r. .W.... ...r...d.....r...rdW
W...r.r d..q.Wd.r.Wr.dW. ..d. .. r....rW
Wr..r.... ..W.... .WdW.....r.... .W...rW
W..r..d.r..W ...dW..W..W ...rq.r..W..d.W
W W. .d.r.W. .d.W.... ..W..r......Wr ..W
W.rW.d...W .r....W. .r.W...d.qd..rW.r..W
W...W...W..r...r..W.d.W....d..WWWWWWW..W
Wd...W..r.rr....r..W.W...r .... ..Wd..rW
W.rr. W.......d...Wr..Wr....W. ..dW..r.W
W.r....Wrq.....q.W...d.W...qdWd...W....W
W.......W.... ..W ..P...W...d.W.r.. .r.W
W... q.r.....rr rW..r .W ..dr..W....rddW
W .. .dr... .r....W...Wr........W......W
W.d.W.... .r....d..W.W.r...r...q.W.r..WW
W...Wd.   ....... W...Wq....d...  W..WqW
W.WWWWWWWWWWW...qW.....W. .... .....Wr.W
W...Wrd...qr...rW....r..W.......r..W...W
W.. W....r.q ....W. .rdW.qr.. ...dW.. .W
W.d.W..d... . ...rW...W..r...d.r.Wd. q.W
Wr.....d.q..r...d.........d.........d  X
WWWWWWWWWWWWWWWWWWWWWWWWWWWWWWWWWWWWWWWW
[/map]
[/cave]

[cave]
Name=Cave 2
CaveDelay=9
CaveTime=160
DiamondsRequired=70
DiamondValue=7 9
AmoebaTime=155
Colors=Black Black Green Red Yellow

[map]
WWWWWWWWWWWWWWWWWWWWWWWWWWWWWWWWWWWWWWWW
Wa          d d  a       wcccccccccccccX
W          dw wd         w c     c  c  W
W         dw   wd        w  ccccc cc ccW
W        dw     w        w   c c     ..W
W     dddwdddd           w    c  ......W
W   wwwwwwwwwwww  wd     w   .r...r..r.W
W     dw           wd    wr........rr..W
W    dw             wd...wr.....r...rr.W
W   dw           ..r.wd..w.r..rr...r...W
W  dw        .........wd.w....r......  W
W  w     ...rr....r..r.wdw.......      W
W    ...r...r......r.r..ww.r.          W
W.r...P.r.......r..r.....w             W
W..........r.........    w             W
Wr.....r....r....c       w             W
Wr..r........c                       ..W
W..r.....c                       ....r.W
W....c                       ..r...r..rW
Wc                       ............r.W
W                    ..r.....rr...r..r.W
WWWWWWWWWWWWWWWWWWWWWWWWWWWWWWWWWWWWWWWW
[/map]
[/cave]

[cave]
Name=Cave 3
CaveDelay=8
CaveTime=190
DiamondsRequired=50
DiamondValue=10 20
MagicWallTime=120
Colors=Black Black LightBlue LightRed White

[map]
WWWWWWWWWWWWWWWWWWWWWWWWWWWWWWWWWWWWWWWW
WrdWddWrrWrdWdrW...........drwrdwrdrrdrX
WrrWrrWdcWrdWrdW...........wdrwrdwrdwddW
WdcWrqWrdWqrW...............wrddrrwdrwdW
WrdWdrWrdWdrW..           ...wrdwrdrddrW
WqdWdrWrrW..... WWWWWWWWW ....wddwddwrdW
WdrWrdWdrW..... W      qW .....wrdwdrwrW
WrdWqrW........ W   r  qW ......w..wrdwW
WrdWrrW........ W   .r  W ..........wdrW
WrdW..........  W   P. qW  ..........rdW
WdrW           wW      qWw           .wW
W..  wwwwwwwwwwrW       Wrwwwwwwwwww ..W
W.. w............qqqqqqq...........   .W
WM.  wwwwwwwwwwwWWWWWWWWWwwwwwwwww    .W
W M.            W      qW             MW
W  M............W      qW............M W
W   M...........W       W...........M  W
W    M..........W      qW..........M   W
W     M.........W      qW.........M    W
W      .........W       W........M     W
W       .........qqqqqqq.........      W
WWWWWWWWWWWWWWWWWWWWWWWWWWWWWWWWWWWWWWWW
[/map]
[/cave]

[cave]
Name=Cave 4
CaveDelay=8
CaveTime=120
DiamondsRequired=40
DiamondValue=8 10
Colors=Black Black Brown Green Cyan

[map]
WWWWWWWWWWWWWWWWWWWWWWWWWWWWWWWWWWWWWWWW
Xrr.dwwd..rwr. rr  rr   rr rr   rr rrr W
Wrrw.r..rww..  ..  ..   .. ..   .. ... W
W.d..drw.dr.                           W
Wwdrw.rww..  d  d  d  d    d   d  d  d W
W.wrwwddw.  q.  .cq.  .c   .c q. q.  .cW
W.d.rd...    d  d  d  d    d   d  d  d W
Wrdr..w.     .  .  .  .    .   .  .  . W
W.w.rr.                                W
Wrrwd.                 q               W
Wwr..  .rw.ww.    .wrdd..    .r.wr..   W
Wd..  qd.d.rwrc   drr.wrw   q.w.w.dwc  W
Ww.    .wwdr..    ..ww.dw    w.drw..   W
W.     .r.wdd.c   w.r.d..    drwd.d.c  W
W      w.rr.rw    .wd.rwd    ...dr.w   W
W      dw.wdw.c   rr.wwr.    w.rrww.c  W
W      .......    .......    .......   W
W                  c c c               W
W                                      W
W                                      W
W                         P            W
WWWWWWWWWWWWWWWWWWWWWWWWWWWWWWWWWWWWWWWW
[/map]
[/cave]

[cave]
Name=Cave 5
Intermission=true
CaveDelay=4
CaveTime=90
DiamondsRequired=3
DiamondValue=99
SlimePermeability=0.125
MagicWallTime=1
Colors=Black Black Orange LightGreen Yellow

[map]
WWWWWWWWWWWWWWWWWWWW
W.r.....r...r.....rW
W.s.....s...s.....sW
WW W...W W.W W...W W
WWcW   WcW WcW   WcW
W W     W   W     WW
X    w     w   w   W
W w   w   w  w  w  W
W  w   w w  w    w W
W            P     W
WMMMMMMMMMMMMMMMMMMW
WWWWWWWWWWWWWWWWWWWW
[/map]
[/cave]

[cave]
Name=Cave 6
CaveDelay=9
CaveTime=170
DiamondsRequired=40
DiamondValue=12 20
Colors=Black Black Green Gray2 Purple

[map]
WWWWWWWWWWWWWWWWWWWWWWWWWWWWWWWWWWWWWWWW
Wccr cccr  cccc    r ccc cccrcrr ccrcrcW
W r.r rr.r      rrr.   r  rr. ..rrr. . W
W . . .. .rr  rr...  rr. r..    ...    W
W         ..  ..     ..  .             W
W                            w         W
W   q                        w      w  W
W                   q              q   W
W                     w      w     qw  W
W                     w      w      w  W
W      www   ww  wwwwwwwww wwwwww wwww W
W      qw             w     qw      w  W
W q                   w      w      w  W
W q               q       P            W
W                q    w      w      w  W
W       wq     w      w      w      wq W
W  ww wwwwww wwwwww wwwwww wwwwww wwww W
W       w      w      w      w      w  W
W              w      wq     w      w  W
Wq                    w      w      w  W
W     qc c c        c c c       q c c cX
WWWWWWWWWWWWWWWWWWWWWWWWWWWWWWWWWWWWWWWW
[/map]
[/cave]

[cave]
Name=Cave 7
CaveDelay=8
CaveTime=190
DiamondsRequired=70
DiamondValue=6 8
AmoebaTime=180
Colors=Black Black Gray1 Brown White

[map]
WWWWWWWWWWWWWWWWWWWWWWWWWWWWWWWWWWWWWWWW
Wa      .rrrr.Wcc   .................r W
W       .rrrr..Wcc   ................W W
W       .rrrr...Wcc   ..............WW W
W       .rrrr....Wcc   ... ........W W W
W       .rrrr.....Wcc   .w w......WW W W
W       .rrrr......Wcc   w w.....W r W W
W       .rrrr.......Wcc  w w....WW W W W
W   w   .rrrr........Wcc w wdddW W W W W
W  w w  .rrrr........dWccw wddWW W W W W
W w   w .rrrr........ddWcw wdW.r W W W W
W       .rrrr........dddWw wW..W W W W W
W  w w  .rrrr...wwwwwwwwww w...Wqw W W W
Ww  w  w.rrrr..           P w...WW W W W
W w   w .rrrr...wwwwwwwwwww  w...W W W W
W       .rrrr........dddWrrw  w...WW W W
W w   w .rrrr........ddW.rr.w  w...Wqw W
W  w w  .rrrr........dW..rr..w  w...WW W
W       .rrrr........Wd..rr...w  w...WqW
W w w w .rrrr.......Wdd..rr....w ....WwW
W       .rrrr......Wddd..rr..........W.X
WWWWWWWWWWWWWWWWWWWWWWWWWWWWWWWWWWWWWWWW
[/map]
[/cave]

[cave]
Name=Cave 8
CaveDelay=9
CaveTime=200
DiamondsRequired=80
DiamondValue=5 7
MagicWallTime=20
Colors=Black Black Purple LightRed Yellow

[map]
WWWWWWWWWWWWWWWWWWWWWWWWWWWWWWWWWWWWWWWW
Wr.rq            .r.rd..dqwd...rdwdrr.qW
Wdr.wwwwwwwwwwwwwd.rdr.r.rwrw.r.rwrrrw W
Wrddwrrrr..rdrr.ww.d...rddw.wd.ddw.drw W
Wdrdwdddrrrddrdr  wrd.drdrw.wr.r.w.drw W
Wrrdwrddrddr.rr.w  wrdrdddwrwrdddw.ddw W
Wdrrw.d..d.rdr..ww  wd.r..wrwr..rw.ddw W
Wrrdwrdr.r.drddrwrw  w....wrwddd.wdrdw W
W.ddwrr.rrr..drrwrdw  w..r..w..d.w.rrw W
Wrd.wr.d.d.r..rrwrdrw  wd...wrrddwrdrw W
Wrr.wrwwwwwwwwwwwrr.dw  w..dwd.drw.ddw W
Wd.rw.drrd....q.wdrrddw  w.rw.dd....rw W
Wdrdw..r....d.rrwrd...ww wwwwwwwwwwwww W
Wrq.wrddrrr.dr.dwd..d.ww w.r.d...dqrdw W
Wdr.wdd.....r.rrwr.ddrww wddr.drdrrdrw W
Wr..w.rrrr.ddd.rwdrd..ww wr.d.r...dq.w W
Wr.rwrdrrrrrr..Pwr..rdww w..d..rrd...w W
Wdrrw.rdd..rrdrrwr.rd.wwqwdrddrd..r.dw W
Wdd.wddrd..rrd.dwr...rwwwwrdd..ddddr.w W
Wrdrwwwwwwwwwwwwwr..d.wwwwMMMMMMMMMw.w W
Wrd.             ..r.d               w X
WWWWWWWWWWWWWWWWWWWWWWWWWWWWWWWWWWWWWWWW
[/map]
[/cave]

[cave]
Name=Cave 9
CaveDelay=8
CaveTime=100
DiamondsRequired=99
DiamondValue=5 7
AmoebaTime=95
Colors=Black Black Cyan Gray2 Red

[map]
WWWWWWWWWWWWWWWWWWWWWWWWWWWWWWWWWWWWWWWW
WaaaaaaaaaaaaaaaaaaaaaaaaaaaaaaaaaaaaaaW
W. r  . . .....q .  r.c.r. r .rcrqr  .rW
Wr..c.... r r .rc. .r.... .. c.. . r rrW
W....q  r  . ... r..c .q..rrrc. rc. .r W
W cc.r.rq r.. ..cr ...rr... r....r.r ..W
Wq  .r  q.  . .rqr. .q   ...r...r...c. W
Wrr rc ..c .. crcr.r .r qr     r.r. qq.W
W.r r.rrc. r....q . qr  .c .rr .rrq ...W
W..q.rcc r..r.q c . r .rrrr.  r......q.W
W .c....r. ....rq  r.  c .  cr.rr..qq..W
W...r..rr  .crc.rc r.c  .. . q .. ..c. W
W.r..  ...r . . qrc..cr.r.r ..rrr.rq.r.W
W ..... c. r..rc.r r..r   r. c r .. .crW
Wr.rr.q. r...rr.r .  .r  r ..... rq.c  W
W.r.r..q.c.. c r....c .rcr..r .r r.... W
Wc .Pr rc.r. r.rcrr.r.rcc.    .r   r rrW
W rc..q.q .r r.r.r .. . rr rc. .....r.rW
W..cr.  . r.q.. c... .  ......rr .. ...W
W . .r. qr.r .. ... c.q.. c q.r.rcrqr..W
X r ......r .rr c ..r .r. . .rrr r.r..cW
WWWWWWWWWWWWWWWWWWWWWWWWWWWWWWWWWWWWWWWW
[/map]
[/cave]

[cave]
Name=Cave 10
Intermission=true
CaveDelay=4
CaveTime=30
DiamondsRequired=1
DiamondValue=30 50
Colors=Black Black Green Gray3 Red

[map]
WWWWWWWWWWWWWWWWWWWW
X           r c W  W
WWWWW       W  cW  W
W  qr       W q W  W
Wc  W     P Wc  W  W
W c W       WWWWWWWW
W c W WWWWW    r c W
WWWWW r c r    W c W
W     Wqc W    W q W
W     Wc  W    Wc  W
W     W   W    WWWWW
WWWWWWWWWWWWWWWWWWWW
[/map]
[/cave]

[cave]
Name=Cave 11
CaveDelay=9
CaveTime=220
DiamondsRequired=80
DiamondValue=7 10
Colors=Black Black Yellow Gray1 White

[map]
WWWWWWWWWWWWWWWWWWWWWWWWWWWWWWWWWWWWWWWW
WrrrWdWddrWdWrrrW.WrddWdWrdrWrWdrrWrWr.W
W.drWrWr..WrWrrdWrWddrWdWrr.WrWrrdW.W.dW
WdrrW.W.rrWrWdddWrWrdrWdWdddW.WrdrW.WrrW
WrddXdW.ddWrWrrrWdWdd.W.WrrdW.WdddWdWrrW
W                                      W
W.rdWrWddrW.WddrWrWr.rWdWrrrWdWdrrWrWr.W
WrddWdWrd.WrWrdrWdWddrWrWrrrWrWdr.WrWddW
WrrdWrW.ddWdWrddW.WrdrWrWrrrWdWd.rWdWr.W
WrddWdWrddWrWd.rWdWd.dWrWdddW.WdddWrWrdW
WddrWrWdd.W.Wdd.WdWdr.WdWddrWdWddrWrWd.W
W                                      W
WrdrW.W.drWdW.drW.WdrrWdWd..WdW.drWdW.dW
WdrrWdWrdrWdWrrdWrWrddWrWrddWrWrrdWdWrdW
Wrd.WrWrdrWdWr..WrWdddWrWrrrW.WdddWdWrrW
WddrWrWrddW.WrrdWdWdddWdWrrdWrWdrdWrWdrW
Wr.dWdW.drW.Wr.rWrW.ddWdWdddWdWd.dW.WrdW
W                                  P   W
WddrWrWrr.WrWrrrWrWr.dWrWrrdWrWd.rWdWdrW
WrddWdWdrdWrWd.rWrWr.rWdWrrrWrWrrrWdWrrW
WdddWrWrdrWdW.rdW.W.rrWrWrdrWrWrrrWrWrdW
WWWWWWWWWWWWWWWWWWWWWWWWWWWWWWWWWWWWWWWW
[/map]
[/cave]

[cave]
Name=Cave 12
CaveDelay=8
CaveTime=160
DiamondsRequired=75
DiamondValue=5 8
Colors=Black Black Red Cyan Yellow

[map]
WWWWWWWWWWWWWWWWWWWWWWWWWWWWWWWWWWWWWWWW
XrdWWWdrdWWWrddWWWrddWWWdrdWWWdrdWWWdrdW
WrrWWWdrrWWWdqrWWWrddWWWdrdWWWcrrWWWddrW
WdrWWWdrcWWWdrdWWWdrrWWWrdrWWWdrrWWWrddW
WrdWWWrddWWWrrdWWWdrdWWWdrdWWWddrWWWrrdW
WrrWWWrrrWWWrrrWWWrrrWWWrrrWWWrrrWWWrrrW
W..   ...   ...   ...   ...   ...   ...W
W                                      W
W                                      W
WWWWWWWWWWWWWWWWWWWWWWWWWWWrrrWWWWWWWWWW
WWWdrdWWWdrdWWWddrWWWdrdWWWdrrWWWdrdWWWW
WWWddrWWWrddWWWddrWWWdrrWWWrdqWWWrddWWWW
WWWrrdWWWdrdWWWcrdWWWrrdWWWdrrWWWdrrWWWW
WWWrddWWWdrrWWWrdrWWWrdrWWWdrdWWWdrdWWWW
WWWddrWWWrrrWWWddrWWWdrdWWWrddWWWrddWWWW
WWWqrdWWWrddWWWdrdWWWdddWWWrddWWWdcrWWWW
WWWrrrWWWrrrWWWrrrWWWrrrWWWrrrWWWrrrWWWW
W  ...   ...   ...   ...   ...   ...   W
W                                      W
W                                      W
W                  P                   W
WWWWWWWWWWWWWWWWWWWWWWWWWWWWWWWWWWWWWWWW
[/map]
[/cave]

[cave]
Name=Cave 13
CaveDelay=9
CaveTime=100
DiamondsRequired=17
DiamondValue=30 0
Colors=Black Black Gray1 Orange White

[map]
WWWWWWWWWWWWWWWWWWWWWWWW
WWWWWWWWWWWWWWWWXrrrrdrW
WWWWWWWWWWWWWWWWWrddrrrW
WWWWWWWWWWWWWWWWWrrrrrdW
WWWWWWWWWWWWWWWWWdrrdrrW
WWWWWWWWWWWWWWWWWrrdrrdW
WWWWWWWWWWWWWWWWWr.rr.rW
WWWWWWWWWWWWWWWWW.rr.rrW
WWWWWWWWWWWWWWWWWrrrrrrW
WWWWWWWWWWWWWWWWWrrr.r.W
WWWWWWWWWWWWWWWWWrr.rrrW
WWWWWWWWWWWWWWWWWrdr.rrW
WWWWWWWWWWWWWWWWWrdr..rW
WWWWWWWWWWWWWWWWWrrrrrrW
WWWWWWWWWWWWWWWWWdr.drdW
WWWWWWWWWWWWWWWWWr.rrrdW
WWWWWWWWWWWWWWWWWrrdrd.W
WWWWWWWWWWWWWWWWWrrdrrrW
WWWWWWWWWWWWWWWWW..r...W
WWWWWWWWWWWWWWWWW......W
WWWWWWWWWWWWWWWWW..P...W
WWWWWWWWWWWWWWWWWWWWWWWW
[/map]
[/cave]

[cave]
Name=Cave 14
CaveDelay=8
CaveTime=140
DiamondsRequired=50
DiamondValue=10 20
Colors=Black Black LightGreen Yellow White

[map]
WWWWWWWWWWWWWWWWWWWWWWWWWWWWWWWWWWWWWWWW
X.r..w.r...w.q.r.d..r......w d qdw...r.W
Wr..rw...d..qr...w........w dw dw....qrW
Wrd..w...d.w..r..w.......w dw  w d.....W
Ww.wwwww.wwwwww.www.....w dw  w dw.w.wwW
W.q..w.r..rwd..........w dw d  dw....d.W
Wr.r.w........r....w .w dw dw  w...r..rW
Wrr....d.r.w...r..w dw dw dw  w..w...rrW
W....w..rr.w.....w dw  w dw  w...w..d.rW
Www.www.wwwww...w  w  w dw  w..d.wr...rW
W....w...q.w...w  w  w  w  w..rwwww.wwwW
Wdd.rw.r...w..w  w  w  w  w......w..r..W
Wr...w.d.r...w  w  w  w  w.....drw...r.W
Wr..dw......w d   w dw. w...r..........W
W...qw.....w dw Pw dw......w.r...w.q...W
Ww.wwww...w dw dw dw....wwwwwww.wwwww.wW
W....w...w  w dw dw......r.w.d..rw....rW
Wd.r.w..w  w  w dw......d..w..d....d...W
W.r.....  w  w  w.....q......r...w..r..W
W........w  w  w........r..w...r.w..r.dW
W..r....w  w  w....ddr.r.q.wrq...w.r..dW
WWWWWWWWWWWWWWWWWWWWWWWWWWWWWWWWWWWWWWWW
[/map]
[/cave]

[cave]
Name=Cave 15
Intermission=true
CaveDelay=4
CaveTime=30
DiamondsRequired=1
DiamondValue=3 5
AmoebaTime=5
Colors=Black Black Yellow Red Purple

[map]
WWWWWWWWWWWWWWWWWWWWW
Wq W qWWW q WqWWWWqXW
W     WW       WW qWW
WWq                WW
WWW               WWW
W q   aaaaPaaa   WWWW
W     aaaa aaa  qWWWW
Wq                WWW
WW                qWW
WW qW     qW     WWWW
WWWqWWq qWWW Wq WWWWW
WWWWWWWWWWWWWWWWWWWWW
[/map]
[/cave]

[cave]
Name=Cave 16
CaveDelay=8
CaveTime=150
DiamondsRequired=25
DiamondValue=15 20
SlimePermeability=1.000
Colors=Black Black Red LightBlue Yellow

[map]
WWWWWWWWWWWWWWrWWWWWWWWWWWWWWWwwwswwWWWW
W             .               w    w   W
W  r       wwwsw       r      w  qcw   W
W  .    P  w q w       .      w cc .   W
wwwsww     w  cw     wwswww   wwwwww   W
w  c w     w cc.     w   cw    r       W
wq c w   r wwwww     w  q w    .       W
w c  w   .           . c qw wwwsw      W
w    . wwsw     r    wwwwww w  qw      W
wwwwww w cw     .           w   w      W
W      wcqw  wwwswww        wcc w      W
W      .  w  wq    w        w  c.      W
W      wwww  w cq  w        wwwww   r  W
W     r      w  cc .                .  W
W     .      wwwwwww  r         wwwwswww
W   wwswww            .         w      w
W   w q  w          wwswwww     wc q c w
W   w  c w          w  q  w     . c q  w
W   . c  w          w  cc w     wwwwwwww
W   wwwwww          . q   w            W
W                   wwwwwww            X
WWWWWWWWWWWWWWWWWWWWWWWWWWWWWWWWWWWWWWWW
[/map]
[/cave]

[cave]
Name=Cave 17
CaveDelay=8
CaveTime=160
DiamondsRequired=99
DiamondValue=4 5
AmoebaTime=120
Colors=Black Black Red Orange Green

[map]
WWWWWWWWWWWWWWWWWWWWWWWWWWWWWWWWWWWWWWWW
Wq.  q..q .rr .cr    c  . .c.q  c    ..X
Wc  q. .    q     .cc.c.r.    c.q  ac qW
W .   r..c.a   r..a .    q ..a     . . W
W c.  .. .    . . .  cq c. .rr. c q c .W
W   .  .. c.q   .c     c.q  r qq ..  c.W
W  ...  q    . c.   r .    c   r  .a   W
W ... ...        . .. r .   . a ..  r aW
W  ..   .   .   .    q    c c  .. .qc. W
Waacq.. . .   .  . . c  . . .  rc.aaq qW
W. r cc.  . .. . q   .. ..  ac  a  .   W
Www.www.www wwwawww www.www.www.www wwwW
W  c  .    . ar. ..  .c ... ca.    r  .W
Wwwwwrwww www www www.www.www www.www wW
W c q   q   ar .  .P .  . q.ar  .    ..W
Wc.r. . ca c.   a   . .r   ...  .cr   qW
W.c.c.  . a. . .      ra     .c.. .   .W
W.      q   . rr  .  q  r .ac  . q a.c W
W ...ac r . .a.    c  a.  q  .. c .  ..W
W qq             q. . . ...  .. r. c. qW
W... .q c a  r c . .q c   c  ra. . q   W
WWWWWWWWWWWWWWWWWWWWWWWWWWWWWWWWWWWWWWWW
[/map]
[/cave]

[cave]
Name=Cave 18
CaveDelay=9
CaveTime=255
DiamondsRequired=40
DiamondValue=10 15
SlimePermeability=1.000
AmoebaTime=170
Colors=Black Black Gray3 Yellow White

[map]
WWWWWWWWWWWWWWWWWWWWWWWWWWWWWWWWWWWWWWWW
W......r.rr.......r..rr.r..r..r.......PX
W.s...rrr...r.r.aa..rr.......rr......r.W
W.ss.r.r...r.......r.......r.rr.r..r..rW
Wr.s.r....r.r....rrr..r...r...r.r.....rW
Wr......r....r...r..rr.rr...rr.r...r...W
W..r........r.r..r.....rr.r.......r.r..W
W..rr...r..............r....r......r..rW
W.....r...r...r.r.........r...r.r..r.r.W
Wr.r.....r..sr.r...r..r....rr.r......r.W
W.r.....r..sssr...r....rr..rr...rr...r.W
W..r...r...rss.....r..r....r....r.r....W
W...r.rr......r.............r.r....r...W
W..........rr....r...rrrr..............W
W...........r...r.r..r..r.r...r.rr...r.W
Wr......rr.......r...r.r.r....r..r...r.W
W.r.....r.....r.r.r...rr.r....r.r..r.r.W
W.....r....rr.r.......rr.r....r.....rr.W
Wa.r...r..rrrr..r.....r......r...r.r..rW
Wa..r..r.r.rr..r.....r.....r...aarrr.r.W
W.r........r..r.rr..ssr....rr...a..r..rW
WWWWWWWWWWWWWWWWWWWWWWWWWWWWWWWWWWWWWWWW
[/map]
[/cave]

[cave]
Name=Cave 19
CaveDelay=8
CaveTime=140
DiamondsRequired=30
DiamondValue=12 16
MagicWallTime=40
Colors=Black Black Orange LightGreen Yellow

[map]
WWWWWWWWWWWWWWWWWWWWWWWWWWWWWWWWWWWWWWWW
W                                      W
W    qw      w      wc     w      w    W
W     w      w      w      w      w    W
W wwwwww.wwwwwwwwwwwwwww.wwwwwwwwwwwww W
W     wd..rr.wrr..d.w.r..rrw.r.r..w    W
W     wd..rr.w.r.r..wr..d.rwr..rr..    W
W     wd..rr.w..d..rwrd.rd.w.r....w    W
W     wd..rr...d.rd.w..d.d......rrw    W
W     wd..rr.w.rr...wrd..rrw......w    W
W wwwwwwww.wwwwwww.wwww.wwwwMMMMMMwwww W
W     w.rr.d.wrr.r..w.r.rd.w..rr.rw    W
W     w.....rwr....rw.r.rd..d.r.d.w    W
W     w.d.r..w.rr.....r.rd.w.....rw    W
W     ...dr..wr.r.rrw.r.rd.wrdd.r.w    W
W     w.r...Xw......w.r.rd.w.r...dw    W
W wwwwwwwwwwwwMMMMMMwww.wwwwwwww.wwwww W
W     w      w      w     qw      w    W
W     wc     wc     w     qw   P qw    W
W     w      w      w      w      w    W
W                                      W
WWWWWWWWWWWWWWWWWWWWWWWWWWWWWWWWWWWWWWWW
[/map]
[/cave]

[cave]
Name=Cave 20
Intermission=true
CaveDelay=4
CaveTime=30
DiamondsRequired=15
DiamondValue=20 30
Colors=Black Black LightGreen Brown White

[map]
WWWWWWWWWWWWWWWWWWWWW
WPd....w.w.wxw.....WW
W...w..x.wdd.dx.w.dWW
Wd.x.xdw.xw......xdWW
Wd.d.d.......xd.dddWW
Wdd.wdx..x.x...dw..WW
Wwdx.x..xwd.xdd.d.wWW
Ww...d...w.xw.x....XW
Wxdd...d.d....ww.xdWW
Www...w.x.xx.d....wWW
W.w.w...d.w.w....dxWW
WWWWWWWWWWWWWWWWWWWWW
[/map]
[/cave]
[/game]
[/BDCFF]
