; Converted using Tim Stridmann's X2BDCFF converter.
; Last modified: 14 January 2007

[BDCFF]
[game]
Name=Arno Dash 20
Author=Arno Weber
Date=December 2006
WWW=http://www.boulder-dash.nl/
Charset=Original
Fontset=Original
Levels=1
Caves=20

[cave]
Name=Cave 1
CaveDelay=8
CaveTime=100
DiamondsRequired=1
DiamondValue=99 0
AmoebaTime=255
MagicWallTime=6
Colors=Black Black Blue LightRed Yellow

[map]
WWWWWWWWWWWWWWWWWWWWWWWWWWWWWWWWWWWWWWWW
XPrq.r .dW......................rqr    W
WWW Wwr W.......................c.rWWW W
WrW Wrwr ..................... .r.rWaW W
WrwWwrWwr .................... .r.rWaW W
Ww   w..wr ................. .cWr.rWaW W
W   w....wr ................ w..r.rWaW W
W  w......wr ............. .c...r.rWaW W
W w........wr ............ w....r.rWaW W
W W.........wr ......... .c.....r.rWaW W
W W..........wr ........ w......r.rWaW W
W W...........wr ..... .c.......r.qWaW W
W ...r.........wr .. . w........r.rWaW W
W ...c..........wr . .c...........rWaW W
W ...r...........wr.qW............rWrW W
W ...r............w ..............r r  W
W ...r.....r.....r.....r.....r....rrrwwW
WM...c. ...c. ...c. ...c. ...c. .WWc...W
Wc. .r. . .r. . .r. . .r. . .r. . Wr...W
W . .rWc. .rWc. .rWc. .rWc. .rWc. .r. .W
WwWq.r..Wq.r..Wq.r..Wq.r..Wq.r..Wq.r  .W
WWWWWWWWWWWWWWWWWWWWWWWWWWWWWWWWWWWWWWWW
[/map]
[/cave]

[cave]
Name=Cave 2
CaveDelay=8
CaveTime=170
DiamondsRequired=30
DiamondValue=10 15
MagicWallTime=50
Colors=Black Black Brown Red Green

[map]
WWWWWWWWWWWWWWWWWWWWWWWWWWWWWWWWWWWWWWWW
Wwwwww.....................wwwwwwwwwwwwW
Ww.dr.d.                 ...r.rrwdr...wW
Wwr..r.. ............... ....dr.w...XdwW
Ww..dr.. .          .... q  .......P.rwW
W....... .          ....... ...dwr...rwW
W.       .  rrrrrr  .rrrrr. ..r.w.r.d.wW
W. .......  .wwdd.  .wcddw. .wwwwwwdwwwW
W. .rrrrr.  .drw.d  .wrdcw. .r..w...r.wW
W. .wddcw.  wdw.r.  ...rrw. ....wr....wW
W. .wcrrw.  w.rddw  .wrq... .......r..wW
W. .wrd...  dr.d.d  .wqdrw.   q    ..dwW
W. ...rrw.  .d.ww.  .wrdcw........ ...wW
W. .wrcqw.  wwwwww  ...rrw.r.r.r.. ..wwW
W. .wqrrw.   c  c   .wdr....r.r.r. ....W
W. .wrd...          .wwwww.r.r.r..    .W
W. ...drw............................ .W
W. .wwwww.MMMMMMMMMMMMMMMMMMMMMMMMMM. .W
W. .................................. .W
W.     q                           q  .W
W......................................W
WWWWWWWWWWWWWWWWWWWWWWWWWWWWWWWWWWWWWWWW
[/map]
[/cave]

[cave]
Name=Cave 3
CaveDelay=8
CaveTime=140
DiamondsRequired=30
DiamondValue=10 12
AmoebaTime=90
MagicWallTime=10
Colors=Black Black Purple Orange Yellow

[map]
WWWWWWWWWWWWWWWWWWWWWWWWWWWWWWWWWWWWWWWW
Wa     . .  .      a  .        .. .   aX
W   .. . ..       ..  . . ..           W
W r.  .    ... ..... . .     .        .W
W . ..  . . . . .   .     .        .   W
W . w    . . . ..  .        .       .  W
W  w   .    .....       .w  wr.    M ..W
W.x. r.   w w        w. w . .x.  r. M. W
Ww. w..  w  .w  w.  w. w .w.. w .  M M.W
W  wrw. w  w  w .w w  w .  w   w. M   MW
W w . .x. w    w .w  w..x.. w  .x.  M .W
Ww . .w  w . .  w  w . w     w   w.  M W
W......................................W
W......................................W
Wc    . .      .    .          . .  ..cW
Wcr  r .   . .         .  .      .. ..cW
Wc  ..    .   .    P    ..r    . .    cW
Wc .   . .             ..  . .  . . ..cW
Wc..        . .  .     ..    .   .r   cW
Wc     ..          ..    . r .  . .  .cW
Wc..   ..   . . .       ..  .     .. .cW
WWWWWWWWWWWWWWWWWWWWWWWWWWWWWWWWWWWWWWWW
[/map]
[/cave]

[cave]
Name=Cave 4
CaveDelay=8
CaveTime=190
DiamondsRequired=40
DiamondValue=12 15
Colors=Black Black Brown LightBlue Cyan

[map]
WWWWWWWWWWWWWWWWWWWWWWWWWWWWWWWWWWWWWWWW
WWWWWWWWWWWWWWWWWWWWWWWWWWWWWWWWWWWWWWWW
W d .   W.rcWWWWWWWWW.rdWWWWWrdrW d .. W
WdddW   ... WWWWWWWWW.rdWWWWW.r.WdddWW W
W   Wr  W.. WWWWWWWWW.rdWWWWW....   WW W
WWWWW.WWWWWWWWWWWWWWW.WWWWWWWWWWWW.WWW W
WWWWW   W.r..   W.r.W..rWWWWW   W...WW W
WWWWW   W...W  rW.r.....WWWWW   ..r.WW W
WWWWW   ....W  ...r.W...WWWWWq  WrdrWW W
WWWWWW.WWWWWWWWWWWWWWWW.WWWWWWW.WWWWWW W
WWWWW.r.. d WWWWWdr.W   W...W  rWWWWWW W
WWWWW...WdddWWWWWdr..   W...W  .WWWWWW W
WWWWW...W   WWWWWdr.Wq  ..r.W   WWWWWW W
WWWWWWW.WWWWWWWWWWWWWWWWWW.WW.WWWWWWWW W
Wdr..   W.r.W d .   WWWWW   W.r.. d WW W
Wdr.W   ..r.WdddW   WWWWW   W...WdddWW W
Wdr.Wq  W.r..   Wc  WWWWW   W...W   WW W
WWWWWW.WWWWWWWW.WWWWWWWWW.WWWW.WWWWWWW W
WWWWW   WWWWW...WWWWWWWWW.rdW   WWWWWW W
WWWWW P WWWWW.r.WWWWWWWWW.rdW   WWWWWW W
WWWWW   WWWWWrdrWWWWWWWWW.rd.c  WWWWWXqW
WWWWWWWWWWWWWWWWWWWWWWWWWWWWWWWWWWWWWWWW
[/map]
[/cave]

[cave]
Name=Cave 5
Intermission=true
CaveDelay=3
CaveTime=20
DiamondsRequired=20
DiamondValue=25 40
Colors=Black Black Gray1 Blue Cyan

[map]
WWWWWWWWWWWWWWWWWWWW
Wd..... dr.rw. ... W
W. w. .dd.d.......rW
W ww. r..w.d. dr. .W
W. .......d.wr www.W
W....r.w.w.r rw.d..W
Www..d. r..d .d..wXW
W r.. ...ddw ..r. wW
W.r.d.d ...d.wd....W
W..r..d..rw d......W
Wwr.r ...P.. ..d..wW
WWWWWWWWWWWWWWWWWWWW
[/map]
[/cave]

[cave]
Name=Cave 6
CaveDelay=9
CaveTime=120
DiamondsRequired=1
DiamondValue=99
MagicWallTime=10
Colors=Black Black Red Purple White

[map]
WWWWWWWWWWWWWWWWWWWWWWWWWWWWWWWWWWWWWWWW
WX...........r.w.r...r...r.....rw...rr.W
W.....r.r..r...w............r...rw....qW
W...wwwwwwMw..rwq..r.......w......w....W
W.....r.......rw.....r..r...wr.....M.rqW
W.....w.r.....qw..rwww..r....w.q....w.rW
W....w..w...r..w..r.....r....rw..r...w.W
W..qwr...w.r...w...r....r..r...wr.....rW
Wr.wr.....w....w..r...r.....r..........W
Wrw..r.....w..r..r......wwwwwwr.r......W
Ww...r......w...r.r.........r....rr.r..W
Wr...........w....r.wwwwwr........r....W
W...r.rr.rr...............w.....r..q...W
W...r...r.....r...r.r...rw.r...rwwwwwwwW
W...r.wwwwww.rr.w.r..r..w.r..r....r..r.W
Wr.r.qr...rr.rrw.......w.r..q...r......W
Wr.wwwwwww..r.w.......w.r..rr.........rW
W....r.....r.w.q....rw....rq.w.....wr..W
Wr....rrr.r.w..q.w..Mr..r...w....r.w...W
W..rr......w....rw.....r...w...q.r.wr..W
WP..r....q..r.r..w....rr.rwr..rr.......W
WWWWWWWWWWWWWWWWWWWWWWWWWWWWWWWWWWWWWWWW
[/map]
[/cave]

[cave]
Name=Cave 7
CaveDelay=8
CaveTime=160
DiamondsRequired=45
DiamondValue=10 15
MagicWallTime=999
Colors=Black Black LightRed Orange White

[map]
WWWWWWWWWWWWWWWWWWWWWWWWWWWWWWWWWWWWWWWW
W        WrrqrdrrrW                    W
W        WddrdrqdW        WWWWWWW      W
W        WdrdrddW         WdqdrW       W
W   P    WddddrW          WddrW        W
W        WddrrW           WdrW         W
W        WrdrW            WdW          W
W        WddW             W.           W
W WWWWWW WdW                  WWWWWWWWWW
W WdrqW  W.        WWWWWWWWW  WdddrddW W
W WrdW             WrdrdrdW   WdrddrW  W
W WdW   WWWWWWWWW  WdrqddW    WqrdrW   W
W W.    WdrddrdW   WrqrrW     WrddW    W
W       WrdrqrW    WrddW      WddW     W
W       WdddrW     WddW       WdW  WWWWW
W       WdrdW      WdW        W.   WrrdW
W       WdrW       W.              WddWW
W       WdW                        WdW W
W       W.                         W.  W
W                                      X
WMMMMMMMMMMMMMMMMMMMMMMMMMMMMMMMMMMMMMMW
WWWWWWWWWWWWWWWWWWWWWWWWWWWWWWWWWWWWWWWW
[/map]
[/cave]

[cave]
Name=Cave 8
CaveDelay=9
CaveTime=250
DiamondsRequired=99
DiamondValue=3 4
AmoebaTime=200
MagicWallTime=9
Colors=Black Black Orange Green Yellow

[map]
WWWWWWWWWWWWWWWWWWWWWWWWWWWWWWWWWWWWWWWW
Xa... .       w   w   wc  . .  . a ...aW
W .. ...   .aw.c.w . w. c  c .  aa.c.. W
W.  c....c  wc. w . wa.cc. ..  .  . ...W
W. .. ..   wc. w..cw..a.   .   .... .  W
W. ....  cw   w .aw.c ..c     .c. ..   W
Wc. .. . wc cwc. w  ....  c. . c. . .c.W
Wcc..c.cw . w. .w   c .a..     c.. .   W
W.   . w ..w.. w  .   . ...   cc  .c. .W
W  .. w.caw..cw  ..    . . c. .cc.c.c .W
Wc   w ..w..cwc c. c ..c..  ..  . ..   W
W . wc.cw.  w...c  c.     .c.  .. c .. W
W  w   w . w..c.   .   .c ... .. .cc   W
W w   w . w.... .c      ....c   cc.cc .W
WM.  wc..w.c..c   .  . .. P..c. .c ..  W
W. cw .cwc..c  ....... .. ... c  .c.  .W
W..w .aw.. . ...... ...  . .c. .       W
Wcwc  w.. ..c.. .....  c  .   .c . c ..W
WM  .wc.  cc ...a... .c.    ..c c   c  W
W . w. .cc  c .......  ..c  . .c   .c  W
W. w. .  ... .cc..c ..  ..             W
WWWWWWWWWWWWWWWWWWWWWWWWWWWWWWWWWWWWWWWW
[/map]
[/cave]

[cave]
Name=Cave 9
CaveDelay=7
CaveTime=70
DiamondsRequired=7
DiamondValue=70 0
Colors=Black Black Purple Gray2 White

[map]
WWWWWWWWWWWWWWWWWWWWWWWWWWWWWWWWWWWWWWWW
wd.www....ww....wwwwwwwdwwwdwww....wwwdX
ww..ww.ww.wwdww.wwwwww..www..wd.ww.ww..w
www..w..w.dwwww..wwww..w...w.wwww..w..ww
wwww..w..wwwwwww.www..ww.w...w....w..www
wwwww..w..wwwww..ww..www..wwww.www..wwww
wwwwww..w..www..ww..wwwww..www.ww..wwwww
wwwwwww..w..ww.www.wwwwwww.ww..w..wwwwww
wwwwwwww..w..w.www.wwwwwww.w..w..wwwwwww
wwwwwwwww.ww.w.www.wwwwwww.w.ww.wwwwwwww
                                        
                                        
                                        
                                        
                                        
                                        
                                        
                                  P     
                                        
                                       q
qqqqqqqqqqqqqqqqqqqqqqqqqqqqqqqqqqqqqqqx
WWWWWWWWWWWWWWWWWWWWWWWWWWWWWWWWWWWWWWWW
[/map]
[/cave]

[cave]
Name=Cave 10
Intermission=true
CaveDelay=3
CaveTime=30
DiamondsRequired=28
DiamondValue=26 0
Colors=Black Black LightGreen Brown White

[map]
WWWWWWWWWWWWWWWWWWWW
W.....wwPrqX..d.w..W
Wdd.wd..wW W......dW
W..ww.d..W W.dw.d.wW
Ww....dwdW W.d...dwW
W.w...w..W w..w.d..W
Wd..dw...W W.w...w.W
Wd...w...w Wd...w..W
W.w...d..W W...d..dW
W..w.d..dW Ww.d..ddW
W.d..d.w.W W..d.w..W
WWWWWWWWWWWWWWWWWWWW
[/map]
[/cave]

[cave]
Name=Cave 11
CaveDelay=9
CaveTime=170
DiamondsRequired=60
DiamondValue=8 10
Colors=Black Black Orange Gray2 Cyan

[map]
WWWWWWWWWWWWWWWWWWWWWWWWWWWWWWWWWWWWWWWW
Wdqd d d d d dqd d dqd dqd d dqd d d dqW
WW W W W W W W W W W W W WWWWW W WWWWW W
Wd WWW d d WWW d d d W W d d d d d d W W
WW W W W W W W W W W W W W W WWWWW W W W
Wd W d d d W d d d d d W d W d d d d W W
WW W W WWWWW W X W W W W W W W W W W W W
Wd d d d W d d d d d W W d W d d d d d W
WW W W W W W WWWWW W W W W WWWWW W W W W
Wd d d d d d d d d d d d d d d d d d d W
WW W W W W W W W W W W W W W W W W W W W
Wd WWW d d d d W d d WWWWW d d W d d d W
WW W W W WWWWW W W W W W W W W W W WWWWW
Wd d d d d d d W d d d d W d d W d d d W
WW W W W W W W W W W W W W W W W W P W W
WWWW d WWW d W W WWWWWWW W d d d d d d W
WW W W W W W W W W W W W W W W W W W W W
Wd W d d W d W d d d d d d d W d d WWW W
WW W W W W W W W W W W W WWWWW W W W W W
Wd d d d d d W d W d d d d d d d d d d W
WW WqWqW W WqWqW W W W WqW WqW WqWqW WqW
WWWWWWWWWWWWWWWWWWWWWWWWWWWWWWWWWWWWWWWW
[/map]
[/cave]

[cave]
Name=Cave 12
CaveDelay=8
CaveTime=100
DiamondsRequired=92
DiamondValue=5 10
Colors=Black Black Brown LightRed Yellow

[map]
WWWWWWWWWWWWWWWWWWWWWWWWWWWWWWWWWWWWWWWW
W..d......d.d.........dd.......d......dW
W.d...d..dd.WWWWWWWWWWWWWWWWWWWWWWWx.xWW
WWWWWWWWx.xWq  q  q  q  q  q  q  q  q   
  q  q  q  q WWWWWWWWWWWWWWWWWWWWWWWx.xW
Wx.xWWWWWWWWW....d....dd.W.d..........dW
W..........d......d...d.dW...d..d.d...dW
Wd.....d...d..d...d....d.W..d....dd..d.W
W.d.....ddd..........WWWWWx.xWWWWWWWWWWW
WWWWWWWWWWWWWWWWWx.xWq  q  q  q  q  q   
  q  q  q  q  q  q  q WWWWWWWWWWWWx.xWWW
WWWWWWWx.xWWWWWWWWWWWW.....d..d.....d..W
W..d.......d...d..W...d....d.......d.d.W
W.d....d.d..d.d..dWd.d..d.d.....d......W
W..dd........d.dd.W..d....d...Wx.xWWWWWW
WWWWWWWWWWWWWWWx.xWWWWWWWWWWWWq  q  q   
  q  q  q  q  q  q  q  q  q  q WWWWWx.xW
WWWWx.xWWWWWWWWWWWWWWWWWWWWWWWW........W
W.d.......d..........W..d.......d..d..dW
X.d.d....d....dd....dW..d....d.d...Pd..W
W.dd...d.d...dd...dd.W.d..d....d.......W
WWWWWWWWWWWWWWWWWWWWWWWWWWWWWWWWWWWWWWWW
[/map]
[/cave]

[cave]
Name=Cave 13
CaveDelay=9
CaveTime=150
DiamondsRequired=4
DiamondValue=99 0
Colors=Black Black Gray1 Orange White

[map]
WWWWWWWWWWWWWWWWWWWWWWWWWWWWWWWWWWWWWWWW
WdrrrrrWWWWWWWWWXrrrr.rWWWWWWWWWWrr.rrdW
Wr.rrrrWWWWWWWWWWrr.rrrWWWWWWWWWWr.rrrrW
WrrrrrrWWWWWWWWWWrrrrrrWWWWWWWWWWrrrrrrW
Wr.r.r.WWWWWWWWWW.rr.rrWWWWWWWWWWrr.rr.W
Wrr.rrrWWWWWWWWWWrr.rrrWWWWWWWWWW.rr.r.W
WrrrrrrWWWWWWWWWWrrrr.rWWWWWWWWWWrr.rrrW
W.r.rr.WWWWWWWWWW.rr.rrWWWWWWWWWW.rrrrrW
Wr.r...r.r..rr.r.rrrr.r.rrr.rrrr...r...W
W.r..r.r.r.rr.r..rrr.r.r.rr.r..rr.r....W
Wrrr.rr..r...r..rrr.rrr..r...r.r.....r.W
Wr.r.r..rrr.r....r.r.rr.r..r.r.rr.rrr.rW
W.rr..r..r.r.r.rrr.r..r..r.r.r.r.r.r...W
Wrr...rWWWWWWWWWWrrrrrrWWWWWWWWWWr.r...W
W.rr...WWWWWWWWWW.r..r.WWWWWWWWWW.r....W
W.rr...WWWWWWWWWWr.rrr.WWWWWWWWWWrrr.r.W
Wrrr.r.WWWWWWWWWWrr.r..WWWWWWWWWW.rrr.rW
W.r.r.rWWWWWWWWWWrr.rrrWWWWWWWWWWr.....W
Wr.r...WWWWWWWWWW..r...WWWWWWWWWWr.rr.rW
Wrr..r.WWWWWWWWWW......WWWWWWWWWWr...r.W
Wd....rWWWWWWWWWW..P...WWWWWWWWWW.rr..dW
WWWWWWWWWWWWWWWWWWWWWWWWWWWWWWWWWWWWWWWW
[/map]
[/cave]

[cave]
Name=Cave 14
CaveDelay=8
CaveTime=175
DiamondsRequired=90
DiamondValue=5 8
MagicWallTime=50
Colors=Black Black Purple Cyan White

[map]
WWWWWWWWWWWWWWWWWWWWWWWWWWWWWWWWWWWWWWWW
Wr..r..drr.r.r  qqqqqqqqqqqWddrdr.qWrddX
W....r..drrr............r.rWrdrrdW WrdrW
W.......dr.rrr.rrd.........WdrrddW WrrrW
WrM.r.....rrdr.r..rr.....r.WWW.WWW WW.WW
W.rM...r.rrddddr.r..r..rr.rWdrrrdW WdrdW
W...M..dr..rrddrr..rr....drWrrddrW WrdrW
Wd...M.r.....r.r.d.r.rr.r.rWrdrddW WdrrW
W.r.drM.......d.....r.....rWrrddrW WrrrW
W.drd..M..d..rrd...r...dr..WdrrdrW WdddW
Wrdd....M....r....r...rr..dWWW.WWW WW.WW
W..ddd...M.d....d........rrWrdrddW WrdrW
WM..dd.ddrM.....d.r.d.d.dr.WdrdrdW WdrrW
W.Mddd...d.M...rr..d.rrr...WrdrrdW WdrdW
W..Mr.r.r.r.M..r....r.dr...WdddrrW WdrdW
W...M..dr..r.M...........r.WrrdrrW WrdrW
WPr.dMd.drd.r.M........rr..WWW.WWW WW.WW
W..rd.Md...d...M....rr...r.W    qW W  qW
Wrrr..rMr.r.....M.........dW     W W   W
Wd...r..M.d.r.r..M........rW     W W   W
W..r......rr..d.r.M...r.r...     W .   W
WWWWWWWWWWWWWWWWWWWWWWWWWWWWWWWWWWWWWWWW
[/map]
[/cave]

[cave]
Name=Cave 15
Intermission=true
CaveDelay=3
CaveTime=40
DiamondsRequired=99
DiamondValue=4 5
AmoebaTime=1
Colors=Black Black Orange Red Yellow

[map]
WWWWWWWWWWWWWWWWWWWWW
Wa .   r      r   aWW
W .  . .      . . rWW
W.  .   q  q   r r.WW
Wr   .r        . . WW
W.    .   P   .    WW
W       q  q .     WW
W   r..          r WW
W . .        r  r. WW
W       .    .  .  WW
Wa ..  .       .  aXW
WWWWWWWWWWWWWWWWWWWWW
[/map]
[/cave]

[cave]
Name=Cave 16
CaveDelay=8
CaveTime=170
DiamondsRequired=50
DiamondValue=6 8
AmoebaTime=160
Colors=Black Black Green Cyan Yellow

[map]
WWWWWWWWWWWWWWWWWWWWWWWWWWWWWWWWWWWWWWWW
W...a....a....a....a....a....a....a....W
W                                      W
W......................................W
W                                      W
W......................................W
W                                      W
W......................................W
W                                      W
W......................................W
W.xcqqcccc                    qccccccx.W
W.xcccqccc                    qqcccccx.W
W.xcqqcqcc                    qcqccccx.W
W.xcccqccc                    qccqcccx.W
W.xcqcqccc                    qcccqccx.W
W.xccqcqcc                    qccccqcx.W
W.xcccqccc                    qccccqcx.W
W.xcqqcccc                    qcccqccx.W
W.xcqqcccc                    qccqcccx.W
W.xxxxxxxxxxxxxxxxxxxxxxxxxxxxxxxxxxxx.W
X..................P...................W
WWWWWWWWWWWWWWWWWWWWWWWWWWWWWWWWWWWWWWWW
[/map]
[/cave]

[cave]
Name=Cave 17
CaveDelay=8
CaveTime=180
DiamondsRequired=99
DiamondValue=3 4
AmoebaTime=160
Colors=Black Black Purple Orange Green

[map]
WWWWWWWWWWWWWWWWWWWWWWWWWWWWWWWWWWWWWWWW
Xr.r. cc rWcW ....acc.cc.. Wr.....q..raW
W....c. ccWaW aa.. rr..aqW Wcc.a..ccqacW
W..r...cra. W q   a ..a. W .c  ..c..c.cW
W. .....c WqWc ca.q. ... W.W .c..r.....W
W......  aW W   .r......q.rWrc.. .a. .cW
Wc.....aq.W .  . .. .. ..W.W.q ccr...aaW
W c..ccr..W.Wc q.q. q . rWrW   ..  ..ccW
W r. ac.r.W.W.c c qra .a...Wqq .c  q..qW
W q  cc...W.W..a. .a....cW . .q.q cac .W
Wq .a......aWq.q . cq....WcWa. c c.r.q.W
W   r a.a.WcW.... ..rc.c W.W....rc r. cW
W.c. . .c.W ... .q . . rc..W.a....cq..cW
W.     c. W.W..a  .c. .ccWrWaqqa... . .W
W.a. . . .WcW...  .  . ..W.W.. aaqc.q..W
W. q. ccc W .aca ...... .Wa.  .   c.c  W
W..  cc.c.W.Wcq....P.. c WcWcq..rqcq   W
Wrc ..r .a.qW ......... q..W. rc  c. .qW
Wca.....acW.W..........qcWcW..rc   . . W
W  q......W Wc..c..cr ...WcW.  c.rcq.  W
W.a..... rW .. ...qr qr. Wc.r.a ccc .cqW
WWWWWWWWWWWWWWWWWWWWWWWWWWWWWWWWWWWWWWWW
[/map]
[/cave]

[cave]
Name=Cave 18
CaveDelay=9
CaveTime=120
DiamondsRequired=50
DiamondValue=10 15
SlimePermeability=0.250
MagicWallTime=999
Colors=Black Black Yellow Brown Cyan

[map]
WWWWWWWWWWWWWWWWWWWWWWWWWWWWWWWWWWWWWWWW
WrrrdrrrrrrrrdrrrrrrrrdrrrrrrrrdrrrrrrrW
WrrrrrrrrrrrrrrrrrrrrrrrrrrrrrrrrrrrrrrW
WrrrrrrrrrrrrrrrrrrrrrrrrrrrrrrrrrrrrrrW
WrrrrrrssrrrrrrrssrrrrrrrssrrrrrrrssrrrW
Wrrrrrs  srrrrrs  srrrrrs  srrrrrs  srrW
Wsrrrs    srrrs    srrrs    srrrs    srW
W W W    M W W M    W W      W W      WW
W W W M    W W      W W  M   W W  M   WW
W W W  M   W WM  M  W W      W W    M WW
W W W      W W      W WM     W W      WW
W W WM     W W     MW W    MMW WM     WW
W W W      W W      W W      W W     MWW
W                                     PW
W W WssssssW WssssssW WssssssW WssssssWW
W                                      X
W W W      W W      W W      W W      WW
W W W      W W      W W      W W      WW
W W W   qq W W   qq W W   qq W W   qq WW
W W W      W W      W W      W W      WW
W W W      W W      W W      W W      WW
WWWWWWWWWWWWWWWWWWWWWWWWWWWWWWWWWWWWWWWW
[/map]
[/cave]

[cave]
Name=Cave 19
CaveDelay=8
CaveTime=220
DiamondsRequired=99
DiamondValue=5 8
AmoebaTime=190
Colors=Black Black Green White Yellow

[map]
WWWWWWWWWWWWWWWWWWWWWWWWWWWWWWWWWWWWWWWW
W.a....a.......w..q     c..............W
W..........w..w....    c  ...r..      qW
W.........w..w..q     c......... wwwwwqW
W........w.......    c  ...r..        qW
W..........w..q     c......... wwww wwwW
W......w..w....    c  ...r..           W
W.....w..w..q     c......... wwwwwwww wW
W....w.......    c  ...r..             W
W......w..q     c......... wwwww wwwww W
W..w..w....    c  ...r..               W
W.w..w..q     c......... wwww wwwwww wwW
Ww.......    c  ...r..   w             W
W..w..q      ......... w w wwwwwwwwwwwwW
W.w....       ...r..   w w wdddddwdddddX
Ww..q      ......... w w   wwwwddwdwwddW
W....       ...r..   w w w wdddddwdwwddW
W.q      ......... w w w w wdwwwwwdwwddW
W..       ...r..qqqw   w w wcwwwwwcwwddW
W      .........qwqw w w w wdddddwdddddW
W       ...r....qqqw w   w wdddddwddddPW
WWWWWWWWWWWWWWWWWWWWWWWWWWWWWWWWWWWWWWWW
[/map]
[/cave]

[cave]
Name=Cave 20
Intermission=true
CaveDelay=3
CaveTime=50
DiamondsRequired=15
DiamondValue=30 40
SlimePermeability=0.250
AmoebaTime=1
MagicWallTime=45
Colors=Black Black White Gray3 Yellow

[map]
Wr..ar..r.r....a.r.WWWWWWWWWWWWWWWWWWWWW
W..rr.a...rr.r.....W...................W
Wa.....r...a..r..arW...................W
sMsMsMsMsMsMsMsMsMsM...................W
W                  X...................W
s s s s s s s s s sW...................W
W                  W...................W
s s s s s s s s s sW...................W
W    P             W...................W
s s s s s s s s s sW...................W
W                  W...................W
MMMMMMMMMMMMMMMMMMMM...................W
W......................................W
W......................................W
W......................................W
W......................................W
W......................................W
W......................................W
W......................................W
W......................................W
W......................................W
WWWWWWWWWWWWWWWWWWWWWWWWWWWWWWWWWWWWWWWW
[/map]
[/cave]
[/game]
[/BDCFF]
