; Converted using Tim Stridmann's X2BDCFF converter.
; Last modified: 14 June 2006

[BDCFF]
[game]
Name=Arno Dash 17
Author=Arno Weber
Date=January 2006
WWW=http://www.boulder-dash.nl/
Charset=Original
Fontset=Original
Levels=1
Caves=20

[cave]
Name=Cave 1
CaveDelay=8
CaveTime=150
DiamondsRequired=60
DiamondValue=8 10
SlimePermeability=0.500
AmoebaTime=10
MagicWallTime=30
Colors=Black Black Green Orange Cyan

[map]
WWWWWWWWWWWWWWWWWWWWWWWWWWWWWWWWWWWWWWWW
WaaaaaaaaaaaaaaaaaaaaaaaaaaaaaaaaaaaaaaW
Wa a a a aaaaaaaaaaaaaaaaaaaaaa a a a aW
WaaaaaaaaaaaaaaaaaaaaaaaaaaaaaaaaaaaaaaW
WssaassaassaassaassaassaassaassaassaassW
X  ssc ssc ssc ssc ssc ssc ssc ssc ss  W
W.                                     W
W       ww     M    w             M    W
W. Mw     w           M     w       w  W
W     M                 w              W
W    M        w   M    w       w      wW
Ww     w   M               M   w       W
W           M    w            M        W
W   w     ww     w      w         ww M W
W                 qqqq            qqqq W
W.W....r.W.r.r..W...r..W.r....W.r..r.W.W
W.Wrr....Wrr....W.....rWr..rr.W..r..rW.W
WrW...r..W....r.W.r...rW...r.rWr....rW.W
W.W......W......W......W......W......W.W
W                                      W
W                 P                    W
WWWWWWWWWWWWWWWWWWWWWWWWWWWWWWWWWWWWWWWW
[/map]
[/cave]

[cave]
Name=Cave 2
CaveDelay=8
CaveTime=180
DiamondsRequired=75
DiamondValue=7 10
SlimePermeability=1.000
Colors=Black Black Orange Yellow White

[map]
WWWWWWWWWWWWWWWWWWWWWWWWWWWWWWWWWWWWWWWW
WwwwwwwwwwwwwwwwwwwwwwwwwwwwwwwwwwwwwwwW
WwP..........................w......r wW
Ww.wwx.wwwwwwwwwwwww.wwwwwwwww.wwwwwwswW
Ww...w.w...x.......w...........w....wqwW
Ww.w.www.xww.w.wwwwwww.xwwwwwwwx.wwww wW
Ww.w.....w...w.......w.x.........x... wW
Ww.www.www.w.xwwww.x.www.wwwww.xww.xw wW
Ww.........w.....x...........x....... wW
Wwwwww.w.xwwwwwwwwwwwwww.wwwwx.wwwwww wW
Ww r...w.............w r...........ww wW
WwswwwwwwwwwwwwwwwwwwwswwwwwwwwwwwwwwwwW
W.q..r........r.WrW ..q......... cw r..W
W. Wrcr......rcr..W W. .........wwwsw..W
W. W.r....r...r.W W W. .......www w w..W
W. W.....rcr....w W W. .....www w wcw..W
W. W..r...r.....W W Ww w..www w wcWww..W
Ww W.rcr.....r..w W Wwwwwww w wcWwwww..W
Ww W..r.....rcr.W W W.www w wcWwwwwd ..W
Ww W.........r..W W W.. w wcWwwwwdd  ..W
Xw W............W . W.. wcWwwwwdd    ..W
WWWWWWWWWWWWWWWWWWWWWWWWWWWWWWWWWWWWWWWW
[/map]
[/cave]

[cave]
Name=Cave 3
CaveDelay=9
CaveTime=160
DiamondsRequired=2
DiamondValue=99 0
Colors=Black Black LightBlue Gray2 White

[map]
WWWWWWWWWWWWWWWWWWWWWWWWWWWWWWWWWWWWWWWW
Wd....................................dX
WWrr.r.rrrrr..r.rr.rr.r.r.rrrrrr.rrrr.WW
Wr.rrrrr.r.r.r.rrr.r.rrr.rrrrr.r.rrrrrrW
W.rrrrrrr.rrrrrrr.rrr.rrrrr.rrrrrrrrrrrW
Wrrrrrrrrrrr.rr.rrrrrrrrrrrrrr.rrrr.rrrW
Wr.rr.rrrrrrrrrrrr.rrrrrrrr.rrr.rrrrrrrW
W.rr.rr.rrrrrrrrrrrr.rr.rrrrrr.rr.rrrrrW
Wrrrrrrrrrrrrrrrrrrrr.rrr.rrrrr.rrr.rr.W
Wrrrrrrrrrr.rrrrr.rrrrrrrrrr.rr.rrrrrrrW
Wrr..rr.rr.rrrrrrrrrrrr.rrrr.rrr.r..rrrW
Wr.rrrr.rrrr.rrrrrrrrrrrrrrrrrrr.rrrrr.W
Wrrrrrr.r..rrrr..rrrrrrrrrrrr.rr.r.rrrrW
Wrrrr.rrrrrrrrrrrrrrrrrr.rrrrrrr.rrr.rrW
Wrrrr.r.rrrr.rrrrrrr.rrrrrrrrrr.rrrrrrrW
W.rr...rrrrrrrrrr.rrrr.rrrr..r.rrrrrrrrW
Wrr.r.rr.rrrrrrrrrr.rrrrr.rrrrr.rrrrr.rW
W.r.rrr.rrrr.rrrrrrrrrrrrrr.r.rrrrrrrrrW
Wr.rrrrrr..rrrr.r.rrrr.rrrrrrrrr.r.rrr.W
W......................................W
W...................P..................W
WWWWWWWWWWWWWWWWWWWWWWWWWWWWWWWWWWWWWWWW
[/map]
[/cave]

[cave]
Name=Cave 4
CaveDelay=8
CaveTime=120
DiamondsRequired=99
DiamondValue=3 4
AmoebaTime=140
Colors=Black Black Gray3 Red Green

[map]
WWWWWWWWWWWWWWWwwwwWWWWWWWWWWWWWWwwwwwWW
cccc        aaawwwwaaaa          wwwww W
cccc        aaawwwXXXaa       .....www W
ccc.......     wwwXXX    ccccc.....    W
W  .......     ww.XXX... ccccXXX...aa  W
W  .......ww   ww....... ccccXXX  aaa  W
W XXX.....ww     .......     XXX  aaa  W
W XXX    www    c.......          aawwww
WaXXX    www    ccc                 wwww
Waa      www    ccc    aaaa         wwww
Waa      ww.... ccc    aaaa   ....     W
W          .... ccc   XXXaa   ....     W
W    ccccc ....       XXX     ....     W
W    ccccXXX...     ..PXX         XXX  W
XXX      XXX        ...     ccccccXXX  W
XXX      XXX        ...     ccccccXXX. W
XXX....           cc...   wwwcccccc... W
W  ....       wwwwccc     www      ... W
W a....ww     wwwwccc     www      ... W
W aa wwww    XXXwwccc   aawww      ... W
W aa wwww    XXX  ccc   aaa            W
WWWWWWWWWWWWWWWWWWWWWWWWWWWWWWWWWWWWWWWW
[/map]
[/cave]

[cave]
Name=Cave 5
Intermission=true
CaveDelay=4
CaveTime=60
DiamondsRequired=18
DiamondValue=28 0
Colors=Black Black LightRed Yellow White

[map]
wwwwwwwwwwwwwwwwwwwwwwwwwwwwwwwwwwwwwwww
wP.......dw...wd...Xw..................w
w.w.wwwwwww.w.www.www..................w
w.w....dwd..w..dw...w..................w
w.wwwwwwwww.wwwww.w.w..................w
w............dw...wdw..................w
w.www.www.wwwww.w.wwwwwww..............w
w...wdwdw..dwdwdw.......w..............w
w.w.www.wwwww.www.wwwww.w..............w
w.w.....w..........dw.w.w..............w
w.www.w.w.www.www.www.w.w..............w
w..dwdw.wdwd..wd..www.w.w..............w
wwwwwww.wwwwwwwwwwwww.w.www............w
w.....w.w.............w...w............w
w.....w.w.............www.w............w
w.....w.w...............w.w............w
w.....w.www.........wwwww.w............w
w.....w...w.........w.....w............w
w.....www.wwwwwwwwwww.wwwww............w
w.......w.............w................w
wwwwwwwwwwwwwwwwwwwwwwwwwwwwwwwwwwwwwwww
WWWWWWWWWWWWWWWWWWWWWWWWWWWWWWWWWWWWWWWW
[/map]
[/cave]

[cave]
Name=Cave 6
CaveDelay=8
CaveTime=200
DiamondsRequired=50
DiamondValue=10 15
SlimePermeability=0.500
MagicWallTime=130
Colors=Black Black Yellow Purple Red

[map]
WWWWWWWWWWWWWWWWWWWWWWWWWWWWWWWWWWWWWWWW
XddrdrrrdWrdddddrddWrdrrrddrrWrddrddrddW
WdrrdrddrWdrrdddrrrWdrdrddrddWdrddrrdrrW
WdrdrdrddWdrdrddrdrWrdrdrdrdrWrrddrrdddW
WrdrddrddWddrdrrdrdWrddrddrrdWddrdrddrrW
WWWW.WWWWWWWWW.WWWWWWWWW.WWWWWWWWW.WWWWW
W        q                   q         W
W   r   WWW   r   WWW   r   WWW   r    W
W   .   WWW   .   WWW   .   WWW   .    W
W   M   WWW   M   WWW   M   WWW   M    W
W        q         c    P    q         W
W s     WWW       WWW       WWW     s  W
W     s WWW       WWW       WWW        W
W   s   WWW     s WWW       WWW  s     W
W        q  s      c   s     q  s      W
W    s  WWW  s    WWW       WWW    s   W
W  s s  WWW       WWW     s WWW     s  W
W       WWW   ss  WWW    s  WWW  s     W
W                  c   s         s     W
W   s   WWW  s    WWW       WWW   s    W
W  s    WWW       WWW   s   WWW        W
WWWWWWWWWWWWWWWWWWWWWWWWWWWWWWWWWWWWWWWW
[/map]
[/cave]

[cave]
Name=Cave 7
CaveDelay=8
CaveTime=150
DiamondsRequired=20
DiamondValue=25 30
Colors=Black Black Orange LightBlue Cyan

[map]
WWWWWWWWWWWWWWWWWWWWWWWWWWWWWWWWWWWWWWWW
Wd..r.....r.r...r..r..d..r..r...r.r..P.W
W...r.....r........r........r.r.r....rPW
Wr..r....r.d................r.....dr..rW
W...r...........r.......r...r......r...W
W...r..r.r..r.d...d..r.r.d.rr...r...r..W
W...r........r.....d...r....r..d.......W
W....r...rdd.rrr..r.........r..d.r...d.W
Ww..wwwwwwwwwwwwwwwwwwwwwwwwwwwwwwwwwwwW
Wq.....q..qq.wWWWWWWWWWWWWWWWWWWWWWWWWWW
W........q...qwWWWWWWWWWWWWWWWWWWWWWWWWW
Wqq.........q.qwWWWWWWWWWWWWWWWWWWWWWWWW
Ww.q..........qqwWWWWWWWWWWWWWWWWWWWWWWW
Wdwqq...........qwWWWWWWWWWWWWWWWWWWWWWW
Wdwwq.q........qq.wWWWWWWWWWWWWWWWWWWWWW
Wdw.wq.q..........qwwwwwwwwwwwwwwWWWWWWW
Wdw.ww...q........qq.q...........wWWWWWW
Wdwqw.wq..........................wWWWWW
Wdw.w..w.q.qq......................wWWWW
Wdw.w...wwwwwwwwwwwwwwwwwwwwwwwwww..wWWW
WXw.ddd..ddd..................ddd....wWW
WWWWWWWWWWWWWWWWWWWWWWWWWWWWWWWWWWWWWWWW
[/map]
[/cave]

[cave]
Name=Cave 8
CaveDelay=8
CaveTime=150
DiamondsRequired=99
DiamondValue=4 8
AmoebaTime=255
Colors=Black Black Purple Brown Green

[map]
WWWWWWWWWWWWWWWWWWWWWWWWWWWWWWWWWWWWWWWW
WW... .arr r r....rqr.   r ..W.c ...c.cX
W.Wc...rcrr.q.rW..acrc.ra. . qW..cq..r.W
WrqWr .a..  .ac.W   a..rc.r . qWar..r. W
W r War.cr crr   W.r. .. c c ccqWar.r .W
Wr.a.W. c .rrqa .qWq...c   rc  rcW.. r.W
W...q.W c .arrc.r .W....... cc ..cW.   W
W cqra.W. ...c . q ..r.c.r ac .... ....W
W  .  c.W.. r.r. crr.W . ..qr... r. W. W
Waccr.. ..rrc r  c.r .Wa .rrrac r.rrrWrW
Waarcc.a  War.cr ca...rW.qarr.r. r.. .WW
W  q r. . .W...ar qr r.PW...c.q a.ar. qW
WWr a c.q. rW..rc.a.r  .qW.c.rqrq.crr.rW
WrWa. r .r...W..cr. cc  c W  rr rra .rcW
W .War .   rr.Wcrrq.aar.q..Wc..crq .ra.W
W.ccW r q .r. rW.........ac.Wq.crr..r rW
W.r c.  c.c r.r......acrc. .aW.r. r.a.rW
Waaa .W ...  r..rW..rc.c   c..W..ccqr.rW
W. qr qW..ar .r...Wr .. .rc .. . r.c.r.W
Wa. .r.aW . .r..c.rW .r.    rcrrW cac qW
W.q. ..qqWr.qr ...rcW .a .rq .  rW r r W
WWWWWWWWWWWWWWWWWWWWWWWWWWWWWWWWWWWWWWWW
[/map]
[/cave]

[cave]
Name=Cave 9
CaveDelay=8
CaveTime=250
DiamondsRequired=30
DiamondValue=15 20
Colors=Black Black Green Gray1 Yellow

[map]
WWWWWWWWWWWWWWWWWWWWWWWWWWWWWWWWWWWWWWWW
W.c...qq..w..r...d..W..q......w..r.....W
W.........w.r....rd.W.....cq..w.drr..r.W
Wc.q....c. ......r.r ......... ....r...W
Wc....c...w...d.....W.c.......wr.......W
W........qw..rr...d.W..q......w..d...drW
W..c......w.d...r..rW.......c.w.r....d.W
Wwwww wwwwwWWWW WWWWWwwww wwwwwWWWW WWWW
W..d.r...dW..q...q..w.r......dW..q.....W
Wrd....rr.W.........w.........W......q.W
W.d.r..r.. ....c.... ....P.r.. .....cq.W
W...rr....W...cq....wr.d...r..W..c.....W
Wdr......rWq......c.w..d....r.W.q.c...qW
W.r...dd..W.q...c...w...r.....W........W
WWWWW WWWWWwwww wwwwwWWWW WWWWWwwww wwwW
W...c...q.w.r..r..rdW.........w......d.W
W.q.......w...r.....W..q...c..w.r......W
Wc........ .......r. ..q...... r..d...rW
W......c..w.d...d...W.........w...r...rW
W..cq..cq.w..r.d.rr.W.c...q.c.w........W
W.....c...w.r..d.r..Wc........w.dd...r.X
WWWWWWWWWWWWWWWWWWWWWWWWWWWWWWWWWWWWWWWW
[/map]
[/cave]

[cave]
Name=Cave 10
Intermission=true
CaveDelay=4
CaveTime=20
DiamondsRequired=1
DiamondValue=0
Colors=Black Black Brown LightRed Green

[map]
XXXXXXXXXXXXXXXXXXXXWWWWWWWWWWWWWWWWWWWW
XdPdddXddddddddddXdX...................W
XPdddddddddddXXddddX...................W
XddXXddXXdddXddXddXX...................W
XdddXdddXdddddXXddXX...................W
XdddXddddXddddddddXX...................W
XdXddddddddddddXdddX...................W
XdXddddddddXddXddddX...................W
XddddddXXXXddXdddddX...................W
XddddddddXddddddddXX...................W
XXddXddddXdddddXdddX...................W
XXXXXXXXXXXXXXXXXXXX...................W
W......................................W
W......................................W
W......................................W
W......................................W
W......................................W
W......................................W
W......................................W
W......................................W
W......................................W
WWWWWWWWWWWWWWWWWWWWWWWWWWWWWWWWWWWWWWWW
[/map]
[/cave]

[cave]
Name=Cave 11
CaveDelay=10
CaveTime=140
DiamondsRequired=27
DiamondValue=20 0
MagicWallTime=60
Colors=Black Black Brown LightBlue White

[map]
WWWWWWWWWWWWWWWWWWWWWWWWWWWWWWWWWWWWWWWW
XqrP.......................r.....r.....W
Wqr ....r.............r..............r.W
WqWW........r.r............M.....M.....W
Wq..r...M.......r.....M.r.. ..... .r.M.W
Wq.....r ...M.M....... ....W.....W... .W
Wq..M...W... . .M..r..W.M..........M.W.W
Wq.. ..M....W.W. ....... .......... ...W
Wq..W.. ........W..M....W.....r....W...W
Wq..r..W........r.. ...........r.......W
Wq.................W..........M........W
Wq..M....r......M.....r....... M.......W
W... ........... .............W .......W
W...W....M......W.....M........W....r..W
W....r... ....r....... ...r......r.....W
W........W............W.............M..W
W....M......r.M...........M......M.. ..W
W.... ........ .....r.r... ...... ..W..W
W....W......M.W...........W......W.....W
W........... .......M.M................W
W...........W....... . ................W
WWWWWWWWWWWWWWWWWWWWWWWWWWWWWWWWWWWWWWWW
[/map]
[/cave]

[cave]
Name=Cave 12
CaveDelay=8
CaveTime=150
DiamondsRequired=99
DiamondValue=3 4
AmoebaTime=110
Colors=Black Black Purple Blue Green

[map]
WWWWWWWWWWWWWWWWWWWWWWWWWWWWWWWWWWWWWWWW
W    a        a   a  a          WccccccW
W                              WcccccccW
W                             .ccccccccW
W                            WcccccccccW
W                           WcWccccccccW
W      W                   Wc  WcccccccW
W     W W                 W... .WccccccW
W    Wr. W               Wc  r.  WcccccW
W   Wr c ..             X     q . WccccW
W  Wq . c..W           XdX.. . r. rWcccW
W Wc cr.  ..W         Xddd...  . . rWccW
WWqc q.q ....W       XddPddX. . ..q  WcW
W rqrccc. r...W     W.XdddX. .. q ... WW
Wc r.r  c c ...W   W....dX  q.c  . q.. W
Wr c r . . r ...W W.....X. .. r c .  r W
W   r r cr .  ...W...r...r. .r   q. c.rW
W.. . . c .c.r ......  q .qq . .... . cW
W   .  ..r  cr.c...c .  r . .r. c rq   W
W .  . qr  c   ..  .  . r .c .    . q cW
W  . .q   q q .  .   ..c  .   . c. . c.W
WWWWWWWWWWWWWWWWWWWWWWWWWWWWWWWWWWWWWWWW
[/map]
[/cave]

[cave]
Name=Cave 13
CaveDelay=10
CaveTime=110
DiamondsRequired=50
DiamondValue=8 12
Colors=Black Black LightGreen Red White

[map]
WWWWWWWWWWWWWWWWWWWWWWWWWWWWWWWWWWWWWWWW
WrrrrrrrrrrrrrrrrrrrrrrrWXWrrrrrrrrrrrrW
W.....................WWWPWWW..........W
W q    q    q    q    q    q    q      W
W                                      W
W   c    c    c    c    c    c    c    W
W    q    q    q    q    q    q    q   W
W                                      W
W      c    c    c    c    c    c    c W
W  q    q    q    q    q    q    q     W
W                                      W
W    c    c    c    c    c    c    c   W
W     q    q    q    q    q    q    q  W
W                                      W
W       c    c    c    c    c    c    cW
W   q    q    q    q    q    q    q    W
W                                      W
W     c    c    c    c    c    c    c  W
W                                      W
W                                      W
W                                      W
WWWWWWWWWWWWWWWWWWWWWWWWWWWWWWWWWWWWWWWW
[/map]
[/cave]

[cave]
Name=Cave 14
CaveDelay=8
CaveTime=120
DiamondsRequired=10
DiamondValue=50 0
SlimePermeability=1.000
AmoebaTime=130
Colors=Black Black Yellow Green Purple

[map]
wwwwwwwwwwwwwwwwwwwwwwwwwwwwwwwwwwwwwwww
qqqqqw                            aaaa w
qqqqqw                            aaaa w
qqqqqw                                 w
qqqqqw                                 w
qqqqq.                                 w
qqqqqw                                 w
qqqqqw                                 w
qqqqqw                                 w
qqqqqw                                 w
qqqqqw                                 w
qqqqqw.................................w
qqqqqw.................................w
qqqqqw                                 w
qqqqqw   s     s     s     s     s     w
qqqqqw  sas   sas   sas   sas   sas    w
qqqqqw   s  s  s  s  s  s  s  s  s  s  w
qqqqqw     sas   sas   sas   sas   sas w
qqqqqw      s     s     s     s     s  w
qqqqqw                                 w
qqqqqX                               P w
WWWWWWWWWWWWWWWWWWWWWWWWWWWWWWWWWWWWWWWW
[/map]
[/cave]

[cave]
Name=Cave 15
Intermission=true
CaveDelay=4
CaveTime=20
DiamondsRequired=30
DiamondValue=10 15
AmoebaTime=999
Colors=Black Black Blue Orange Yellow

[map]
WWWWWWWWWWWWWWWWWWWWWWWWWWWWWWWWWWWWWWWW
XdrddddrrdddrdddrddW...................W
WdrrddrddrdrrdrrdddW...................W
WrdddrrdddrdrddrddrW...................W
WdrrdddrrddddrrdrrdW...................W
WddddddddddddddddddW...................W
W..................W...................W
W.qa.qa.qa.qa.qa.qaW...................W
W..................W...................W
W                  W...................W
WP   P   P   P   P W...................W
WWWWWWWWWWWWWWWWWWWW...................W
W......................................W
W......................................W
W......................................W
W......................................W
W......................................W
W......................................W
W......................................W
W......................................W
W......................................W
WWWWWWWWWWWWWWWWWWWWWWWWWWWWWWWWWWWWWWWW
[/map]
[/cave]

[cave]
Name=Cave 16
CaveDelay=8
CaveTime=20
DiamondsRequired=30
DiamondValue=3 4
AmoebaTime=999
Colors=Black Black Orange Brown White

[map]
WaaaaaaaaaaaaaaaaaaaaaaaaaaaaaaaaaaaaaaW
W                                      W
W                                      W
W                                      W
W                                      W
W                                      W
WrrrrrrrrrrrrrrrrrrrrrrrrrrrrrrrrrrrrrrW
WqqqqqqqqqqqqqqqqqqqqqqqqqqqqqqqqqqqqqqW
W                                      W
W                                      W
W                                      W
W                                      W
W                                      W
W                                      W
W                                      W
W                                      W
W                                      W
W......................................W
WccccccccccccccccccccccccccccccccccccccW
WPPPPPPPPPPPPPPPPPPPPPPPPPPPPPPPPPPPPPPW
WXXXXXXXXXXXXXXXXXXXXXXXXXXXXXXXXXXXXXXW
WWWWWWWWWWWWWWWWWWWWWWWWWWWWWWWWWWWWWWWW
[/map]
[/cave]

[cave]
Name=Cave 17
CaveDelay=8
CaveTime=120
DiamondsRequired=80
DiamondValue=6 0
MagicWallTime=2
Colors=Black Black Orange Gray2 White

[map]
WWWWWWWWWWWWWWWWWWWWWWWWWWWWWWWWWWWWW
XP.dr..r.XP.dr..r.XP.dr..r.XP.dr..r.W
W.r......W.r......W.r......W.r......W
W...r.dMqW...r.dMqW...r.dMqW...r.dMqW
Wdd.r...rWdd.r...rWdd.r...rWdd.r...rW
WWWWWWWWWWWWWWWWWWWWWWWWWWWWWWWWWWWWW
XP.dr..r.XP.dr..r.XP.dr..r.XP.dr..r.W
W.r......W.r......W.r......W.r......W
W...r.dMqW...r.dMqW...r.dMqW...r.dMqW
Wdd.r...rWdd.r...rWdd.r...rWdd.r...rW
WWWWWWWWWWWWWWWWWWWWWWWWWWWWWWWWWWWWW
XP.dr..r.XP.dr..r.XP.dr..r.XP.dr..r.W
W.r......W.r......W.r......W.r......W
W...r.dMqW...r.dMqW...r.dMqW...r.dMqW
Wdd.r...rWdd.r...rWdd.r...rWdd.r...rW
WWWWWWWWWWWWWWWWWWWWWWWWWWWWWWWWWWWWW
XP.dr..r.XP.dr..r.XP.dr..r.XP.dr..r.W
W.r......W.r......W.r......W.r......W
W...r.dMqW...r.dMqW...r.dMqW...r.dMqW
Wdd.r...rWdd.r...rWdd.r...rWdd.r...rW
WWWWWWWWWWWWWWWWWWWWWWWWWWWWWWWWWWWWW
[/map]
[/cave]

[cave]
Name=Cave 18
CaveDelay=8
CaveTime=220
DiamondsRequired=65
DiamondValue=8 10
AmoebaTime=50
MagicWallTime=60
Colors=Black Black Purple LightRed Yellow

[map]
WWWWWWWWWWWWWWWWWWWWWWWWWWWWWWWWWWWWWWWW
Wrqqqqqqqqqqqqrw.rrr..q        ..r...waW
Wrw..........qrw......q        .....waaW
Wr........rd.qqw......         ....waaaW
Wrw.. w...rd..Mw...r..         ...w.raaW
Wr..w  w..rd..qw.....r.r..r.r....w....aW
Wrw..w  w.rd.. w......r.r.rr....w....aaW
Wr....w w.rd..ww...r....r.......wr.r..rW
Wrw..w  wMwd..www...MMM...MMM...www....W
Wr..w  w   w.w   w.M   M.M   M.w   w...W
Wrwww w  w  w  w  w Pw  M  w  w  w w..rW
Wrd.w   w.w   wxw   wdw   w.w   w  w..rW
Wrw..www...wwwd.xwww...www.r.www  r....W
Wrd...wr.....x....xx.x..wr..dr.w waa...W
Wrw...wq.......x.x.d....wq.dr..w  waaaaW
Wrd...wr....xx..d...xx..wr....r.w  waaaX
Wrw...wq....xd.xd.x..x..wq.r.d..rw .wwwW
Wrd...wr.......x...xd...wr.r..rrr....rdW
Wrw...wq....x.x..x.d....wq....r.r....rdW
W.d...wr....xxxxxxxxxx..wr.....dr....rdW
Www...w.....          r.w...dr..r....rdW
WWWWWWWWWWWWWWWWWWWWWWWWWWWWWWWWWWWWWWWW
[/map]
[/cave]

[cave]
Name=Cave 19
CaveDelay=4
CaveTime=75
DiamondsRequired=28
DiamondValue=20 0
Colors=Black Black Blue Yellow White

[map]
WWWWWWWWWWWWWWWWWWWWWWWWWWWWWWWWWWWWWWWW
W.XdX.drX.X...X.X.X.X.X.X.X...X.X.Xr..XW
W.X.XdX...X.XdX...X...X.X..rX..dX.X.X.XW
Wr..XrX.X.X.X.X.X.X.X.r.X.XrX.X.X.X.X.XW
W.X.X...X...X.X.X.X.X.XdX.X...X.X...XdXW
W.X...XdX.X.XrX.X.d.X.XrX...X.X.X.X...XW
WrX.X.X.XrX.X...XrX.X.X.X.XdX.XrXrX.X.XW
W.X.X.X.X...X.X.X.Xr..X...X.X.X...X.X.XW
W..dX.r.X.X..rX.r.X.X.X.XrX..rX.X.X.X.XW
W.X.XrX.rdX.X.X.XrX.XdXPX...X.r.X.Xr..XW
W.X...X.X.X.X..rX.rr.rX.XdX.XrXdXr..XdXW
WrX.X.X.Xr.rX.X.X.X.X.X...X.X.X..rXrX.XW
W...X..dX.X..dX...X.X...XrXrX.r.X.X.X.XW
W.XrX.XrX.X.X.X.XrX.XrX.X.X.X.X.XrX.X.XW
WdX.X.X.XdX.r.X.X...X..dX...XdX.X.X.r.XW
W.X.X.X...X.X.X.X.Xr.rX.X.X.d.X...X.X.XW
W.X...X.X...X..rXdX.XrX...X.X.X.X.r.X.XW
W.X.X.X.X.X.X.X.X.X.X.X.X.XrX...X.X..rXW
W...X...X.X.X...X..dX.X.X...X.X.X.XrX.XW
W.XdX.X.X..dX.X.X.X...X.X.X...XrXd..X.XW
W.X...X.X.X...X...X.X.Xr..X.X.X.X.X.X.XW
WWWWWWWWWWWWWWWWWWWWWWWWWWWWWWWWWWWWWWWW
[/map]
[/cave]

[cave]
Name=Cave 20
Intermission=true
CaveDelay=4
CaveTime=40
DiamondsRequired=30
DiamondValue=12 20
SlimePermeability=0.250
AmoebaTime=5
MagicWallTime=1
Colors=Black Black Brown Cyan Green

[map]
WWWWWWWWWWWWWWWWWWWWWWWWWWWWWWWWWWWWWWWW
WsassassssassasssasW...................W
X.ar.arraaPaaa.raaaX...................W
WssassssassrsssassrW...................W
Xaa.raaraaaraaaraaaX...................W
Wasssassss.ssasss.sW...................W
XaraaaraaaraaaaaaarX...................W
Wss.ssss.sss.sssrssW...................W
XaaaaaaaaaaaaaaaaaaX...................W
WssssssssssssssssssW...................W
W                  W...................W
WMMMMMMMMMMMMMMMMMMW...................W
W......................................W
W......................................W
W......................................W
W......................................W
W......................................W
W......................................W
W......................................W
W......................................W
W......................................W
WWWWWWWWWWWWWWWWWWWWWWWWWWWWWWWWWWWWWWWW
[/map]
[/cave]
[/game]
[/BDCFF]
