; Converted using Tim Stridmann's X2BDCFF converter.
; Last modified: 30 June 2006

[BDCFF]
[game]
Name=FireFox 50
Author=FireFox
Date=26.6.2004
WWW=http://www.firefox.ch
Charset=Original
Fontset=Original
Levels=1
Caves=20

[cave]
Name=Cave 1. Chain2
CaveDelay=8
CaveTime=150
DiamondsRequired=50
DiamondValue=1 3
Colors=Purple Black Green LightGreen Purple

[map]
WWWWWWWWWWWWWWWWWWWWWWWWWWWWWWWWWWWWWWWW
X.....................................PW
W.rrr.rrr.rrr.rrr.rrr.rrr.rrr.rrr.rrr..W
W..c...q...q...q...q...q...q...q...q...W
W.rrr.rrr.rrr.rrr.rrr.rrr.rrr.rrr.rrr..W
W..c...q...q...q...q...q...q...q...q...W
W.rrr.rrr.rrr.rrr.rrr.rrr.rrr.rrr.rrr..W
W..c...q...q...q...q...q...q...q...q...W
W.rrr.rrr.rrr.rrr.rrr.rrr.rrr.rrr.rrr..W
W..c...q...q...q...q...q...q...q...q...W
W.rrr.rrr.rrr.rrr.rrr.rrr.rrr.rrr.rrr..W
W..c...q...q...q...q...q...q...q...q...W
W.rrr.rrr.rrr.rrr.rrr.rrr.rrr.rrr.rrr..W
W..c...q...q...q...q...q...q...q...q...W
W.rrr.rrr.rrr.rrr.rrr.rrr.rrr.rrr.rrr..W
W..c...q...q...q...q...q...q...q...q...W
W.rrr.rrr.rrr.rrr.rrr.rrr.rrr.rrr.rrr..W
W..c...q...q...q...q...q...q...q...q...W
W.rrr.rrr.rrr.rrr.rrr.rrr.rrr.rrr.rrr..W
W..c.r...r...r...r...r...r...r...r.....W
W....r...r...r...r...r...r...r...r.....W
WWWWWWWWWWWWWWWWWWWWWWWWWWWWWWWWWWWWWWWW
[/map]
[/cave]

[cave]
Name=Cave 2. J50
CaveDelay=8
CaveTime=150
DiamondsRequired=50
DiamondValue=3 4
AmoebaTime=100
Colors=Orange Black Green LightGreen Yellow

[map]
WWWWWWWWWWWWWWWWWWWWWWWWWWWWWWWWWWWWWWWW
Wa               .    a.           .  aW
W. .          .   .    .               W
W     ...         .... .               W
W.                      .       .      W
W   .                 r                W
W    ..      WWWWW    XX r        .    W
W         .  W       XccX.    .        W
W       .  . W      XccccX          .  W
W            Wq     XccccX             W
W        .   WWWW   XccccX             W
WP        .      W  XccccX             W
W                 W.XccccX    .        W
W         .       WqXccccX   .         W
W         ..     W   XccX     .        W
W.           WWWW     XX               W
W .               .                    W
W     .   .        .                  .W
W            . .                       W
W                .                     W
Wa         .    .     .               aW
WWWWWWWWWWWWWWWWWWWWWWWWWWWWWWWWWWWWWWWW
[/map]
[/cave]

[cave]
Name=Cave 3. Mad1
CaveDelay=8
CaveTime=100
DiamondsRequired=22
DiamondValue=5 0
Colors=LightRed Black Brown LightBlue Green

[map]
WWWWWWWWWWWWWWWWWWWWWWWWWWWWWWWWWWWWWWWW
W.x..................................x.W
W.x..................................x.W
W.x..xxxxxxxxxxxxxx..xxxxxxxxxxxxxx..x.W
W.x..x............................x..x.W
W.x..x............................x..x.W
W.x..x..xxxxxxxxxxx..xxxxxxxxxxx..x..x.W
W.x..x..x......................x..x..x.W
W.x..x..x.xxxxxxxxx..xxxxxxxxx.x..x..x.W
W.x..x..x.x..................x.x..x..x.W
W.x..x..x.x.xxxxxxx..xxxxxxx.x.x..x..x.W
W.x..x..x.x.x..............x.x.x..x..x.W
W.x..x..x.x.x..............x.x.x..x..x.W
W.x..x..x.x.x..xxxx..xxxx..x.x.x..x..x.W
W.x..x..x.x.x..x........x..x.x.x..x..x.W
W.x..x..x.x.x..x........x..x.x.x..x..x.W
W.x..x..x.x.x..x..x..x..x..x.x.x..x..x.W
W.x..x..x.x.x..x..x..x..x..x.x.x..x..x.W
W.x..x..x.x.x..x..x..x..x..x.x.x..x..x.W
W.x..x..x.x.x..x..x..x..x..x.x.x..x..x.W
W.xddxddxdddxddxddxPXxddxddxdddxddxddx.W
WWWWWWWWWWWWWWWWWWWWWWWWWWWWWWWWWWWWWWWW
[/map]
[/cave]

[cave]
Name=Cave 4. Zenit3
CaveDelay=8
CaveTime=140
DiamondsRequired=45
DiamondValue=2 4
Colors=Brown Black Green Blue Red

[map]
WWWWWWWWWWWWWWWWWWWWWWWWWWWWWWWWWWWWWWWW
W......................................W
W......................................W
W..rr..rr...rr..rr..rr..rr..rr..rr..rr.W
W......................................W
W..  ..  ...  ..cq..  ..  ..  ..  ..cq.W
W..  ..  ...  ..  ..  ..  ..  ..  ..  .W
W..  ..  ...  ..  ..  ..  ..  ..  ..  .W
W..  ..  ...  ..  ..  ..  ..cq..  ..  .W
W..  ..cq...  ..  ..  ..  ..  ..  ..  .W
W..  ..  ...  ..  ..  ..  ..  ..  ..  .W
W..  ..  ...  ..  ..  ..  ..  ..  ..  .W
W..  ..  ...  ..  ..  ..  ..  ..  ..  .W
XP.  ..  ...  ..  ..cq..  ..  ..cq..  .W
W..cq..  ...  ..  ..  ..  ..  ..  ..  .W
W..  ..  ...  ..  ..  ..  ..  ..  ..  .W
W..  ..  ...  ..  ..  ..  ..  ..  ..  .W
W..  ..  ...  ..  ..  ..  ..  ..  ..  .W
W..  ..  ...cq..  ..  ..cq..  ..  ..  .W
W......................................W
W......................................W
WWWWWWWWWWWWWWWWWWWWWWWWWWWWWWWWWWWWWWWW
[/map]
[/cave]

[cave]
Name=Cave 5. Int197
Intermission=true
CaveDelay=0
CaveTime=20
DiamondsRequired=3
DiamondValue=33 0
Colors=Black Orange Orange Orange Black

[map]
WWWWWWWWWWWWWWWWWWWW
W.....F...F.F......W
W..F..F.....F.....FW
W..FF.F.FF..F......W
WFd.F.F..F..FF.F...W
WFF.F.F..F.d.F.F...W
W.F.F.F..FF.......FW
W.F.F..F...F....F..W
WFF.F...F..F...F...W
X...F...d..F..F....W
WF..F...F.FF..F...PW
WWWWWWWWWWWWWWWWWWWW
[/map]
[/cave]

[cave]
Name=Cave 6. Normal3
CaveDelay=8
CaveTime=150
DiamondsRequired=40
DiamondValue=4 5
Colors=Blue Black Yellow LightRed Purple

[map]
WWWWWWWWWWWWWWWWWWWWWWWWWWWWWWWWWWWWWWWW
Wddrrr....rrrrrrrrrrrrrrrrrrrr....rrrrrX
Wddrrr....r..................r....rrrrrW
Wddrrr....r.rrrrrrrrrrrrrrrr.r....rrrrrW
Wddrrr....r.r..............r.r....rrrrrW
Wddrrr....r.r.rrrrrrrrrrrr.r.r....rrrrrW
Wddrrr....r.r.r..........r.r.r....rrrrrW
Wddrrr....r.r.r.rrrrrrrr.r.r.r....rrrrrW
Wddrrr....r.r.r.r......r.r.r.r....rrrrrW
Wddrrr....r.r.r.r.rrrd.r.r.r.r....rrrrrW
Wddrrr....r.r.r.r.r..r.r.r.r.r....rrrrrW
Wddrrr....r.r.r.r.r.Pr.r.r.r.r....rrrrrW
Wddrrr....r.r.r.r.rrrr.r.r.r.r....rrrrrW
Wddrrr....r.r.r.r......r.r.r.r....rrrrrW
Wddrrr....r.r.r.rrrrrrrr.r.r.r....rrrrrW
Wddrrr....r.r.r..........r.r.r....rrrrrW
Wddrrr....r.r.rrrrrrrrrrrr.r.r....rrrrrW
Wddrrr....r.r..............r.r....rrrrrW
Wddrrr....r.rrrrrrrrrrrrrrrr.r....rrrrrW
Wddrrr....r..................r....rrrrrW
Wddrrr....rrrrrrrrrrrrrrrrrrrr....rrrrrW
WWWWWWWWWWWWWWWWWWWWWWWWWWWWWWWWWWWWWWWW
[/map]
[/cave]

[cave]
Name=Cave 7. Conny3
CaveDelay=8
CaveTime=150
DiamondsRequired=15
DiamondValue=2 30
Colors=Green Black Green Red White

[map]
WWWWWWWWWWWWWWWWWWWWWWWWWWWWWWWWWWWWWWWW
Wd.dWdW...dWdWdWdWd...WWWdW.rrrrrrrrrrqX
WW.WW.W.WWWW.W.W.WWWW...W.W.rrrrrrrrrrrW
Wd....W.W....W.W.WWdWWW.W.W.rrrrrrrrrrrW
WWWW.WW.W.WWWW.W........W.W.rrrrrrrrrrrW
W.......W.W....WWW.W.WWWW.W.rrrrrrrrrrrW
WdWWWWW.W.W.WWWWdW.W......W.rrrrrrrrrrrW
W...........W....W.W.WWWWWW.rrrrrrrrrrrW
WWWWWWWWW.W.W.WWWW.W........rrrrrrrrrrrW
W.........W.W.W....W........rrrrrrrrrrrW
WdWWWWWWWWW.W.W.WWWW........rrrrrrrrrrrW
W.............W.W...........rrrrrrrrrrrW
WWWWWWWWWWW.W.W.W...........rrrrrrrrrrrW
Wd..........W.W.W...........rrrrrrrrrrrW
WWWWWWWWWWWWW...W...........rrrrrrrrrrrW
W.............WWW...........rrrrrrrrrrrW
WdWWWWWWWWWWW...............rrrrrrrrrrrW
W.............W.............rrrrrrrrrrrW
WWWWWWWWWWWWWWW.............rrrrrrrrrrrW
WF..........................rrrrrrrrrrrW
WP..........................rrrrrrrrrrrW
WWWWWWWWWWWWWWWWWWWWWWWWWWWWWWWWWWWWWWWW
[/map]
[/cave]

[cave]
Name=Cave 8. Hot1
CaveDelay=8
CaveTime=150
DiamondsRequired=70
DiamondValue=1 2
AmoebaTime=250
Colors=Purple Black Yellow Gray2 Purple

[map]
WWWWWWWWWWWWWWWWWWWWWWWWWWWWWWWWWWWWWWWW
W   . .   WWWWrrrrrrrrrrrrrrW  .   ..  W
W ..      WqWqqqqqqqqqqqqqqWW  .  .    W
W.  ..    WrrrrrrrrrrrrrrrrW.     .    W
W. . .    WW...............WWW         W
W     .   .WaaaaaaaaaaaaaaaaaW .   .   W
W   . .  .WW         .       W    .    W
W   . . ..W                  W      .  W
W  . . .. W.WWW.WW      WWW WW.        W
W .   . .cW.W W.WWW     W.W.W          W
W. .c. . .    .  .W.WWW W   .  .  .    W
W  c.c  . . ..    W.W W.W   .    .     W
W. . . . . . .        W.W     .        W
W .   . . c.c ...                      W
Wc..c.   . . .. .  . .  .    WWWWW W WWW
W.c ...c. . . c..            W.    W   W
W .. c .c.  c.. c.. .    .   W WWW WWWWW
Wc. ...   . . ... ...     .  W W     . W
W.c  .c. . .  c.  c.         W W W WWWWW
W.. .. ..  c. .....    .    .W W W     X
W c. c. c. . .c . c..        W WPWWWWWWW
WWWWWWWWWWWWWWWWWWWWWWWWWWWWWWWWWWWWWWWW
[/map]
[/cave]

[cave]
Name=Cave 9. Police2
CaveDelay=8
CaveTime=130
DiamondsRequired=25
DiamondValue=5 10
Colors=Red Black Green Brown Yellow

[map]
WWWWWWWWWWWWWWWWWWWWWWWWWWWWWWWWWWWWWWWW
W.....W............W...............W..WW
W.rrr..WXW.........W.....WWWW......W...W
W.rdr...W..........W........W....rWW...W
W.rdr....W.......WWW........WW..r......W
W.rdr....rrrrr..W..rrr.........r..WW...W
W.rdr.W..rrrrrWWW..rrr........r.WWrrW..W
W.rdr.W..rrrrrW....rrr...WWW.r.Wdddd...W
W.rdr.WWWrrrrrW....rrr...W..r...WWrW...W
W.rrr..W...........rrr.WWW.r.......WW..W
W......W....W......rrr....r.......W..r.W
WWWWW..W....W.....Wrrr...r.......W...r.W
Wrr.W..W..WWW.....W...WWr....W..Wr...r.W
Wdrr..WW..WPW.WWWWW...W.....W..W.r...r.W
Wdrrr.....W..W........WWW..W..WW.r...r.W
Wdrrrr.......WW.......W..WW..W.W.r...r.W
Wdrrrrr.....................W..W.r.W.r.W
Wdrrrrrr......W................W.r.W.r.W
Wdrrrrrr.WWWWWW...WdrrrrrdW...WW.r.W.r.W
Wdrrrrrr.Wrrrrr...WdrrrrrdW......rW..r.W
Wd.......Wddddd...WdddddddW......W.....W
WWWWWWWWWWWWWWWWWWWWWWWWWWWWWWWWWWWWWWWW
[/map]
[/cave]

[cave]
Name=Cave 10. Int198
Intermission=true
CaveDelay=4
CaveTime=50
DiamondsRequired=20
DiamondValue=2 5
AmoebaTime=255
Colors=Green Black Yellow Gray1 Green

[map]
WWWWWWWWWWWWWWWWWWWW
W..................W
W..................W
W..    ....    ....W
W.. cc .aa. cc ....W
W.. cc .aa. cc ....W
W..    ....    ....W
W......    ........W
X...... qq ........W
W...... qq ........W
W......    ..P.....W
WWWWWWWWWWWWWWWWWWWW
[/map]
[/cave]

[cave]
Name=Cave 11. Ice3
CaveDelay=8
CaveTime=170
DiamondsRequired=65
DiamondValue=2 10
Colors=White Black LightBlue Blue White

[map]
WWWWWWWWWWWWWWWWWWWWWWWWWWWWWWWWWWWWWWWW
Wddd...ddd...ddd....XW...ddd...ddd..dddW
W......................................W
W                   qc                 W
W......................................W
W                   cq                 W
W......................................W
Wxxxxxx.xxxxx.xxxxxx.xxxxxxxxxxxxx.xxxxW
W......................................W
W......................................W
Wrrwwx..xwwwx..xwwwx.xwwwx..xwwwx..xwwrW
Wrrwd....dwd....dwd...dwd....dwd....dwrW
Wrrwwx..xwwwx..xwwwx.xwwwx..xwwwx..xwwrW
Wrrwd....dwd....dwd...dwd....dwd....dwrW
Wrrwwx..xwwwx..xwwwx.xwwwx..xwwwx..xwwrW
Wrrwd....dwd....dwd...dwd....dwd....dwrW
Wrrwwx..xwwwx..xwwwx.xwwwx..xwwwx..xwwrW
Wrrwd....dwd....dwd...dwd....dwd....dwrW
Wrrwwx..xwwwx..xwwwx.xwwwx..xwwwx..xwwrW
Wrrwd....dwd....dwd...dwd....dwd....dwrW
WrrwwwwwwwwwwwwwwwwwPwwwwwwwwwwwwwwwwwrW
WWWWWWWWWWWWWWWWWWWWWWWWWWWWWWWWWWWWWWWW
[/map]
[/cave]

[cave]
Name=Cave 12. Delta3
CaveDelay=8
CaveTime=100
DiamondsRequired=25
DiamondValue=4 10
Colors=Green Black Gray1 LightGreen Green

[map]
WWWWWWWWWWWWWWWWWWWWWWWWWWWWWWWWWWWWWWWW
X......r.r.r.r...W.........rrr.r..r...rW
W...dr.rrrrrr.r..Wd..W....r......r..r..W
W...r..r....rr...W...W....dr........d..W
W.r.........r...rW...W.................W
Wd.........rr.dd.W...Wr...........r...rW
Wr......r....rr.rW.rrW...r.r..r........W
Wr.r.r...r.......W...W..r.r...r..rr....W
Wd....r.d...r....Wr..Wr....r....r..rr..W
W.r..r......r.rrrW..rW....r.r....rd....W
W.r.dr....r.....PWr..WWWWWWWWWWWWWWWWW.W
W.WWWWWWWWWWWWWWWW...W..dr..........r..W
W...rd....r.....rW...W.dr....r....r....W
Wr.r.rd.........rWrr.Wr......d..r...r..W
Wr..r.r.r....rrr.W..rWd...rrd...r......W
W...d.dr.r.......W...W.rrr...drd..r.r..W
Wr..r.r.r.d..dr..W...W.......rd.....rr.W
W.rr.......r.....W...W..d.......r.rrd..W
W.d....r..r......W...W...........rr...rW
W.....r....d.....W...W.r..rrdr..r.rr.d.W
W......r......r...d..W....r.r..r..d..rdW
WWWWWWWWWWWWWWWWWWWWWWWWWWWWWWWWWWWWWWWW
[/map]
[/cave]

[cave]
Name=Cave 13. Cell3
CaveDelay=8
CaveTime=200
DiamondsRequired=10
DiamondValue=10 25
Colors=Yellow Black Green Purple Yellow

[map]
WWWWWWWWWWWWWWWWWWWWWWWWWWWWWWWWWWWWWWWW
W......................................W
W......................................W
W......WWWWW.WWWWW.WWWWW.WWWWW.WWWWW...W
W......WrrrW.WrrrW.WrrrW.WrrrW.WrrrW...W
W......WrqrW.WrqrW.WrqrW.WrqrW.WrqrW...W
W......WrdrW.WrdrW.WrdrW.WrdrW.WrdrW...W
W......WrrrW.WrrrW.WrrrW.WrrrW.WrrrW...W
W......................................W
W......................................W
W....WWWWW.WWWWW.WWWWW.WWWWW.WWWWW.....W
W....WrrrW.WrrrW.WrrrW.WrrrW.WrrrW.....W
W....WrqrW.WrqrW.WrqrW.WrqrW.WrqrW.....W
W....WrdrW.WrdrW.WrdrW.WrdrW.WrdrW.....W
W....WrrrW.WrrrW.WrrrW.WrrrW.WrrrW.....W
W......................................W
W.......WWWWW.....WWW.....WWWWW........W
W..........rW.....WXW.....Wr...........W
W.......WrdrW.....WPW.....WrdrW........W
W.......WrdrW.....W.W.....WrdrW........W
W.......WrrrW.............WrrrW........W
WWWWWWWWWWWWWWWWWWWWWWWWWWWWWWWWWWWWWWWW
[/map]
[/cave]

[cave]
Name=Cave 14. Romont3
CaveDelay=8
CaveTime=180
DiamondsRequired=50
DiamondValue=3 5
Colors=Green Black LightGreen Blue Green

[map]
WWWWWWWWWWWWWWWWWWWWWWWWWWWWWWWWWWWWWWWW
W......W.........r.W...................W
W.......................r..............W
W................c.................WWW.W
W.......................cr.........W.W.W
W.................r......r.........W.W.W
W.............r..................r.....W
W..........WW.....c......c.............W
W..........WW.c..................c....WW
W..........WW...W..WW..................W
Wr.........W....W.r.W.......r.........WW
Wr..............WW.............WWWW....W
W.................c...WWW...c.....W...XW
Wc..WWWr.........r....WPWW........W....W
W...WrW...............W...........W....W
W......c.........c....r....WWW.........W
W...rc................c....W.W...r.....W
W..........................W.W...W.....W
W...c.....W...r..................c.c...W
W............r.....................r...W
W.............c........................W
WWWWWWWWWWWWWWWWWWWWWWWWWWWWWWWWWWWWWWWW
[/map]
[/cave]

[cave]
Name=Cave 15. Int199
Intermission=true
CaveDelay=8
CaveTime=90
DiamondsRequired=7
DiamondValue=10 0
Colors=Blue Yellow Black Brown Blue

[map]
WWWWWWWWWWWWWWWWWWWWW
WrWrWrWrWrWrWrWrrrrXW
WdWdWdWdWdWdWdWrrrrWW
W.W.W.W.W.W.W.WrrrrWW
W.W.W.W.W.W.W.WrrrrWW
W.W.W.W.W.W.W.W....WW
W.W.W.W.W.W.W.W....WW
W.W.W.W.W.W.W.W....WW
W.W................WW
W.W.WWWWWWWWWWWWWWWWW
W.................PWW
WWWWWWWWWWWWWWWWWWWWW
[/map]
[/cave]

[cave]
Name=Cave 16. Mustair
CaveDelay=8
CaveTime=150
DiamondsRequired=10
DiamondValue=10 15
Colors=Blue Black Blue Gray1 Cyan

[map]
WWWWWWWWWWWWWWWWWWWWWWWWWWWWWWWWWWWWWWWW
W W W W W W W W W W W W W W W W W W W WW
W                                      W
WW W W W W W W W W W W W W W W W W W W W
W   r   r   r r         r   r     r    W
W W W W W W W W W W W W W W W W W W W WW
W                                      W
WW W W W W W W W W W W W W W W W W W W W
W                                      W
W W W W W W W W W W W W W W W W W W W WW
W        c       c                     W
WW W W W W W W W W W W W W W W W W WcW W
W   c                 c                W
W W W W W W W W W W W W W W W W W W W WW
W            c             c    c      W
WW W W W W W W W W W W W W W W W W W W W
W       c             c                W
W W W W W W W W W W W W W W WcW W WcW WW
W                                      W
WW W W W W W W W X P W W W W W W W W W W
W                                      W
WWWWWWWWWWWWWWWWWWWWWWWWWWWWWWWWWWWWWWWW
[/map]
[/cave]

[cave]
Name=Cave 17. Triumph1
CaveDelay=8
CaveTime=100
DiamondsRequired=30
DiamondValue=3 5
Colors=Blue Black Brown LightBlue Blue

[map]
WWWWWWWWWWWWWWWWWWWWWWWWWWWWWWWWWWWWWWWW
W......................................X
W                                   c  W
W....r.......rr........................W
W......................................W
W c                                    W
W.............r...r....................W
W......................................W
W                c                     W
Wrr.......................r...r........W
W......................................W
W                         c            W
W.r...r................................W
W......................................W
W                                 c    W
W............................r.........W
W......................................W
W       c                              W
W.......r...................r..........W
W.....r..r...r.........................W
W.............................Pr.......W
WWWWWWWWWWWWWWWWWWWWWWWWWWWWWWWWWWWWWWWW
[/map]
[/cave]

[cave]
Name=Cave 18. Honey3
CaveDelay=8
CaveTime=100
DiamondsRequired=20
DiamondValue=5 11
Colors=Red Black Yellow Orange Red

[map]
WWWWWWWWWWWWWWWWWWWWWWWWWWWWWWWWWWWWWWWW
Wrr..rrr.rr.....rr.d...rrrrrrd.r..q.r.rW
W.d..rd.rrrrqrr.r..d.q.dr.rr.r....r..rrW
Wr..r.rr.r.r.rrr..rrr..qrd..dr....r.drrW
W..rr.rr..rdrr.r.r.rrr.drrr.rr..rr.r...W
W.r..d.rr.r.r.rrrdr....r.rr..r.rrrrrrrdW
Wr...rr..rd.r......rrr.dq...r.....rr..qW
W.rd.rrrrrrrdr.r..rrrr.r.rq.....r.....rW
Wd..rrd.r.rrrdqr..dq.rr..qrr.rd.r..rrrdW
W..d.r....drr.rrdr.r.r.rrrr..rqr.r..rrrW
Wq.r..rr......d...r.r...dr.rr..dq..rrrrW
Wd....rrrd.....r...drrrr.r.rd.rrrr..r..W
Wrr...r...r..r...rr...rrr..rr..d..r....W
Wrr.r..rrrqr..rr..rr...r..rrdrr.qrr....X
W.rdrrr.r.r..r.dr.r...r.d.rrr.rrrr..rrrW
W.rrd....rrrrrr.rr...........dr.r.rrrrdW
Wr.rr..r..r.r...rr......rr...rrrd.rr.r.W
W.r.r.rrdr.r...rdr...r.rd.rr..r..r.r.ddW
Wrrrq.d...dr.qr..r.....dd..rrrrrrrrrrr.W
W....r.rrrdrrr.r.drrr.rrdrrr..rr.r..rr.W
W..rr..rdr.....r..q.dPr.r...r.qrr.r....W
WWWWWWWWWWWWWWWWWWWWWWWWWWWWWWWWWWWWWWWW
[/map]
[/cave]

[cave]
Name=Cave 19. Chess
CaveDelay=8
CaveTime=250
DiamondsRequired=90
DiamondValue=1 5
AmoebaTime=250
Colors=Gray3 Black Gray1 Gray2 Red

[map]
WWWWWWWWWWWWWWWWWWWWWWWWWWWWWWWWWWWWWWWW
W......................................W
W.....................................aW
W....................................P.W
W...    ....    ....    ....    .......W
W... cc .xx. cc .xx. cc .xx. qq .xx....W
W... cc .xx. cc .xx. cc .xx. qq .xx....W
W...    ....    ....    ....    .......W
W.......    ....    ....    ....    ..aW
W....xx. cc .xx. cc .xx. cc .xx. qq ...W
W....xx. cc .xx. cc .xx. cc .xx. qq ...W
W.......    ....    ....    ....    ...W
W...    ....    ....    ....    .......W
X... cc .xx. cc .xx. cc .xx. qq .xx....W
W... cc .xx. cc .xx. cc .xx. qq .xx...aW
W...    ....    ....    ....    .......W
W.......    ....    ....    ....    ...W
W....xx. cc .xx. cc .xx. cc .xx. qq ...W
W....xx. cc .xx. cc .xx. cc .xx. qq ...W
W.......    ....    ....    ....    ...W
W.....................................aW
WWWWWWWWWWWWWWWWWWWWWWWWWWWWWWWWWWWWWWWW
[/map]
[/cave]

[cave]
Name=Cave 20. Int200
Intermission=true
CaveDelay=8
CaveTime=80
DiamondsRequired=40
DiamondValue=1 2
SlimePermeability=0.125
Colors=Red Black Purple Blue Yellow

[map]
WWWWWWWWWWWWWWWWWWWWW
WddddddddddddddddddWW
WssssssssssssssssssWW
W                  XW
W                  WW
W c   c   c   c    WW
W                  WW
W   c   c   c   c  WW
W                  WW
W                  WW
W                 PWW
WWWWWWWWWWWWWWWWWWWWW
[/map]
[/cave]
[/game]
[/BDCFF]
